user_id,message,published_time,type,love,wow,sad,total
112638779551,C.J. Anderson wants to remind everyone about Mark Sanchez's past success.,2016-06-16 10:02:02,link,31,26,27,84
112638779551,"Leo Messi (goal, 2 assists) and Argentina just too much for U.S. Soccer as they reach the Copa América Centenario final.

#USMNT to play in the 3rd place game. #Copa100 #MyCopaColors",2016-06-21 21:59:33,photo,109,14,37,160
112638779551,JR Smith was a straight-up hero at the Cleveland Cavaliers' parade.,2016-06-22 14:51:36,video,111,99,32,242
112638779551,Von Miller sounds like he totally committed to the Denver Broncos despite the contract dispute.,2016-06-15 16:48:00,link,180,23,7,210
112638779551,"Brock Lesnar said he was the Bo Jackson of fighting. Bo's response?

Andy Nesbitt for @TheBuzzer",2016-06-16 13:08:13,video,1,81,34,116
75932763901,"After confirming their split, Javi Marroquin and Kailyn Lowry make an unexpected announcement — and we can't imagine how their children feel about this! —> http://bit.ly/1Xq5Rhd",2016-06-15 18:00:00,photo,88,92,41,221
25902406772,Bill Murray  was hyped up.,2016-06-15 11:53:04,link,193,13,45,251
7245371700,Keke Palmer dropped knowledge on the haters.,2016-06-16 05:17:13,link,154,35,41,230
95926963131,"From big-screen ingenue to Iron Lady, see Oscar's most-nominated actress transform through the years!",2016-06-23 01:00:00,video,22,54,30,106
10606591490,Michelle Obama has already used Snapchat to tease her upcoming 'Carpool Karaoke' ride.,2016-06-21 16:01:05,link,163,11,2,176
95926963131,Madonna Badger is speaking out about the tragic night her family in a house fire—and how she recovered her will to live.,2016-06-20 15:06:08,link,158,9,26,193
95926963131,It's been a big day for Michelle Obama—and James Corden!,2016-06-21 23:00:38,link,49,5,29,83
112638779551,Brock Lesnar is making up for lost time when it comes to the UFC's drug testing program.,2016-06-21 10:01:45,link,81,9,8,98
13652355666,"A fan at the Copa América Centenario 2016 ran out to hug soccer star Lionel Messi, and security did nothing to stop it: http://usat.ly/28OHPem (Getty Images)",2016-06-22 09:21:00,video,126,29,45,200
10606591490,The Vogue editor drops the mic.,2016-06-16 15:00:15,link,136,83,13,232
112638779551,'The Stripe Show' with Dustin Johnson is taking place during the U.S. Open Championship. #USOpen #LexusRCF,2016-06-18 15:14:12,video,43,5,48,96
25902406772,Dwyane Wade does not take kindly to haters.,2016-06-21 11:56:31,link,100,43,47,190
10606591490,It only takes 30 minutes.,2016-06-16 06:30:27,link,92,51,22,165
112638779551,The NBA Draft has a rich history of picks that missed the mark.,2016-06-23 08:01:28,link,197,95,3,295
10606591490,A Harvard professor weighs in on easy but effective ways to write better.,2016-06-18 13:01:26,link,20,78,49,147
13652355666,"""All about the money."" http://usat.ly/1rs194W",2016-06-16 12:42:00,video,122,6,38,166
75932763901,IT'S A BOY! And wait until you hear his famous mommy's beautiful explanation of his name —> http://bit.ly/1XngEbZ,2016-06-15 17:00:00,photo,87,97,32,216
112638779551,"Here's what Oakmont looked like before 15,000 trees were removed from the course. #USOpen",2016-06-19 10:55:48,video,85,89,13,187
112638779551,"Cleveland had a rough half-century, but one sports city had it even worse. Can you guess which one?",2016-06-20 17:17:35,link,7,22,16,45
112638779551,Bill Walton told his son Luke Walton not to take the LA Lakers job. This is why he did it anyway.,2016-06-22 10:00:03,video,35,6,11,52
95926963131,Melissa Rivers has the perfect response for when her son Cooper brings up Joan Rivers.,2016-06-18 20:20:03,link,78,8,37,123
10606591490,"The 18-year-old was allegedly on his way to ""ISIS-controlled territory.""",2016-06-21 20:30:38,link,36,77,9,122
10513336322,"Amber Arcades: ""My mum played the clarinet when I was growing up, but she used it mainly to get back at the neighbours. She wasn't very good.""",2016-06-20 15:00:00,link,110,30,48,188
13652355666,"""My brother was a genuine person,"" said James Hickey, older brother of the 30-year-old Antonio Davon Brown.",2016-06-19 05:50:00,link,52,55,15,122
25902406772,What.. Just.. Happened?,2016-06-20 10:02:50,link,83,78,9,170
10606591490,Adorable.,2016-06-22 06:00:10,link,16,19,45,80
75932763901,"THINNER THAN EVER! This is what Teen Mom 2 star Kailyn Lowry looked like back in April — but since then, she's lost A TON of weight! See her impressive transformation: http://bit.ly/1Yp7k6T",2016-06-18 10:30:00,photo,171,27,17,215
10513336322,"""Here are five reasons that the former coalition government and the current Tory administration are to blame for your troubles – and not Brussels.""",2016-06-19 07:00:00,link,161,18,20,199
10606591490,This might be the reason you can't get over your ex.,2016-06-15 02:30:17,link,3,45,35,83
75932763901,IT'S OVER! Click here to find out what went wrong (via Life & Style Weekly) —> http://bit.ly/28MNW3w,2016-06-23 03:30:00,photo,188,14,21,223
52150999700,That stunning tragedy on Orange Is the New Black is heartbreaking. 💔,2016-06-20 09:34:00,link,30,12,31,73
75932763901,Lamar Odom finally breaks his silence about his rocky relationship with Khloé Kardashian — and it's not what we expected to hear! —> http://bit.ly/28K8eIy,2016-06-21 01:30:00,photo,132,40,12,184
112638779551,Yusaku Miyazato did a little dance after hitting the early shot of the day at Oakmont.,2016-06-18 10:06:24,link,184,78,34,296
7245371700,Have you read our The 1975 cover story yet?,2016-06-23 07:21:51,link,40,55,49,144
7245371700,Benicio del Toro should probably hire a new PR rep + the media should probably stop talking about Meg Ryan's face right now.,2016-06-18 10:31:09,link,56,33,9,98
18807449704,These cards have got you covered.,2016-06-18 13:10:00,link,106,81,11,198
18807449704,The condom FINALLY got an upgrade.,2016-06-15 19:15:44,link,44,33,25,102
10606591490,4. Set and affirm your goals for the day.,2016-06-16 08:30:10,link,27,6,3,36
112638779551,BREAKING: The NHL officially is expanding to Las Vegas.,2016-06-22 15:51:35,link,46,51,41,138
10606591490,"Very hot drinks are a ""probable"" cancer trigger, according to the WHO. http://ti.me/1PujFQf",2016-06-15 20:15:42,video,118,43,10,171
18807449704,"In the cruel world of Westeros, not everyone can make it through unscathed.",2016-06-20 06:00:00,link,64,94,10,168
112638779551,The Chicago Cubs' next star had the best MLB debut possible.,2016-06-20 14:27:27,link,10,6,8,24
75932763901,GUESS WHO?! Click here to find out (via Life & Style Weekly) —> http://bit.ly/26252jT,2016-06-18 03:30:00,photo,3,89,33,125
18807449704,Has it really been a year?,2016-06-16 20:42:31,link,27,81,30,138
86680728811,JUST IN: The United States Department of Justice: 18-year-old Indiana man arrested on terrorism charge; attempted to travel overseas to join ISIS. http://abcn.ws/28ReRGU,2016-06-21 16:49:43,photo,132,29,28,189
112638779551,Does a new coach mean it's finally time for the Georgia Bulldogs? Who are the dark horse Heisman contenders? Your college football questions answered.,2016-06-23 12:06:57,link,134,11,4,149
7245371700,Phantogram is back & keeping things real.,2016-06-15 23:49:12,link,25,77,45,147
52150999700,The Harry Potter star dishes on all the ridiculous parts of Swiss Army Man. 😂,2016-06-18 18:41:00,link,132,33,42,207
86680728811,3-year-old boy dies after being found in a hot car outside his family's home in northern Houston.,2016-06-16 23:08:06,link,89,98,25,212
5281959998,"""Having traced every step of his journey in detail over eight hours, you still find yourself wondering what the hell happened to this guy. He was made in America, and unmade here, too.""",2016-06-18 23:55:00,link,191,85,48,324
112638779551,"For the first time in 22 years at the U.S. Open, a player has gone bogey-free at Oakmont.",2016-06-17 14:31:12,link,105,62,32,199
13652355666,"""We knew it was only a matter of time.""",2016-06-22 12:21:00,link,189,69,31,289
112638779551,"Promise, DELIVERED.",2016-06-19 22:05:11,photo,3,59,13,75
52150999700,These tributes to the Star Trek actor are heartbreaking.,2016-06-19 14:18:59,link,155,76,50,281
10513336322,"According to the opinion polls, Thursday night's referendum will be tight: surveys generally showed the Leave camp ahead until late last week, when the Remain camp clawed back some ground. But bookmakers, who have already taken in record volumes of bets on this vote, see things very differently. Average odds currently hover at around 1/4 implying a 75% probability that remain will win. So who should you trust?",2016-06-21 03:20:00,link,38,87,6,131
52150999700,The new Justice League synopsis reveals some SUPER plot details.,2016-06-21 19:19:00,link,32,66,36,134
112638779551,No #NASCAR question is off limits for @TheBuzzer's Daryl Motte and FS1's Alan Cavanna.,2016-06-15 13:08:14,video,100,19,46,165
5281959998,"Associate salaries at big law firms are on the rise, and that news has brought a fresh round of law school bashing.",2016-06-21 22:55:00,link,90,79,26,195
95926963131,North West is one lucky little princess! (via People Babies),2016-06-16 10:41:06,link,33,29,14,76
52150999700,"Alright, alright, alright! Matthew McConaughey talks on a possible True Detective return: http://share.ew.com/eRZbtGg",2016-06-23 13:41:00,video,127,9,16,152
25902406772,Guess what -- Craig Sager was the true star of Game 6.,2016-06-17 00:15:58,link,44,72,36,152
25902406772,James Shields has a had a rough month.,2016-06-23 16:20:49,link,190,62,1,253
18807449704,"Chewbacca Mom has fame, riches and now this incredible gift.",2016-06-20 12:15:00,link,134,98,42,274
112638779551,Dustin Johnson had an amazing performance down the stretch at the U.S. Open Championship. #LookAgain #Deloitte,2016-06-20 15:29:50,video,42,49,18,109
112638779551,The only sure thing in the NBA Draft is that there are NO sure things. Here's 10 years of unpredictability summed up in 90 seconds.,2016-06-22 15:28:56,video,147,4,19,170
95926963131,Things have just gotten real in Kevin Hart's parenting world. (via People Babies),2016-06-16 14:43:02,link,114,61,6,181
112638779551,Nevada approves early weigh-ins for UFC 200 and the other events during International Fight Week,2016-06-21 13:49:47,link,124,31,6,161
5281959998,"While the nominating contest ended with a whimper, Bernie Sanders hopes to go out with a roar, Elizabeth Williamson writes in The New York Times Opinion Section.",2016-06-15 23:25:00,link,156,76,3,235
112638779551,"The Golden State Warriors may have lost Game 7, but Ayesha Curry is still proud of her team",2016-06-19 22:52:34,link,94,46,17,157
25902406772,"If...IF LeBron James actually left the Cleveland Cavaliers, where could he go?",2016-06-21 19:13:03,link,64,50,25,139
95926963131,The ladies of Real Housewives of New York City had some bold reactions for Countess LuAnn de Lesseps.,2016-06-15 22:18:19,link,58,12,46,116
75932763901,Have you ever noticed Kate Middleton and Prince William rarely hold hands in public? Find out the surprising reason why they avoid PDA (via Closer Weekly) —> http://bit.ly/1VAaSUb,2016-06-17 06:45:00,photo,106,76,37,219
112638779551,"""They continued to battle, they never quit. LeBron James put the team on his back""- Draymond Green gives credit to the Cleveland Cavaliers",2016-06-19 23:25:56,video,200,94,4,298
75932763901,RIP! Our hearts are breaking to hear about the death of this young actor —> http://bit.ly/1YzwuQ9,2016-06-20 07:15:00,photo,12,72,43,127
25902406772,How about some MLB in Vegas?,2016-06-21 19:56:26,link,127,38,30,195
112638779551,"Need help making better picks for the U.S. Open Championship? You're in luck! 

#USOpen Preview with OddsShark & Outkick The Coverage with Clay Travis.",2016-06-15 14:07:21,video,57,29,40,126
112638779551,The shoe giant was ready to celebrate when the Cleveland Cavaliers ended more than a half-century of misery.,2016-06-20 08:02:21,link,116,94,8,218
10513336322,Why would a set of supporters try to stop a game while their team is winning? And why would they then start a fight among themselves?,2016-06-18 04:50:00,link,145,18,32,195
75932763901,"Just 10 months after her engagement news, Julianne Hough has made a confession that's left her fans SPEECHLESS! Details here —> (via Closer Weekly) http://bit.ly/23gMPtK",2016-06-21 04:00:00,photo,92,68,50,210
18807449704,Warning: The video is extremely graphic.,2016-06-18 10:30:00,link,143,78,46,267
112638779551,"Denny Hamlin has a better chip shot 30,000 feet in the air than you do on solid ground. #NASCAR",2016-06-23 14:42:02,link,174,53,10,237
5281959998,"Are you smarter than a New York Times reporter? Play along with our quiz and find out, as we try to guess which common words and phrases are trademarked. We'll start with a very common two-word phrase that AT&T is being sued for using.",2016-06-21 17:02:03,video,161,12,4,177
112638779551,This is the best.,2016-06-21 01:28:00,video,181,69,28,278
95926963131,The Royal Ascot is a full family affair! (via People Royals),2016-06-17 12:52:46,link,50,94,8,152
52150999700,The only thing better than one Neil Young is TWO Neil Youngs!,2016-06-22 07:18:40,link,89,60,3,152
18807449704,Don't mind us. We'll just be here sobbing over these Disney Pixar edits.,2016-06-17 12:40:00,link,81,48,38,167
25902406772,Alex Cora reports that Royals could have their eye on Jose Reyes.,2016-06-16 14:00:00,link,39,10,45,94
52150999700,Nile Rodgers says he's working on a song partially inspired by the Orlando attack.,2016-06-15 08:01:22,link,119,24,28,171
7245371700,MTV News spoke to a few experts.,2016-06-16 22:54:51,link,199,62,40,301
13652355666,The cheapest seat is going for at least $900 on StubHub.,2016-06-17 14:44:00,link,45,6,46,97
10513336322,"""I've been interviewing celebrities for 16 years now and I have never seen PRs look as miserable as the ones for the condom company who have spent the past three days trying and failing to make Charlie Sheen be at certain places at certain times.""",2016-06-20 14:00:00,link,197,26,26,249
25902406772,The Golden State Warriors have some decisions to make.,2016-06-21 11:57:22,link,152,27,25,204
7245371700,"Isn't it a little hot out for that, Rihanna?",2016-06-18 17:36:07,link,183,69,7,259
18807449704,A pretty horrible moment happened on Orange Is the New Black.,2016-06-21 22:30:00,link,124,61,32,217
52150999700,"Don't worry, Hamilton: An American Musical fans—Jonathan Groff will be back!",2016-06-21 17:06:00,link,7,50,3,60
10513336322,"In Singapore, ""NEWater"" is reclaimed from what substance?

•Low cloud
•House plant condensation
•Sewage
•Sweat",2016-06-17 10:20:00,link,139,15,28,182
52150999700,"Ben Affleck is standing by his passionate, profanity-laced rant about Tom Brady. 😂 🏈",2016-06-23 16:15:57,link,106,76,23,205
10606591490,"TIME's new cover: The Gene Machine. What the CRISPR experiments mean for humanity
http://ti.me/28U3Uag",2016-06-23 07:44:00,video,7,93,17,117
13652355666,"""Assume everything is sticky."" Here's to you, dads!",2016-06-19 13:20:00,link,147,18,36,201
7245371700,"Don't be quick to write off The 1975 as a ""boy band.""",2016-06-22 06:00:07,link,194,78,22,294
112638779551,The Philadelphia Phillies need to get this dad a contract.,2016-06-17 06:02:05,link,21,100,10,131
95926963131,Flesh-eating bacteria victim Aimee Copeland discusses her journey to recovery and how she learned to embrace her new body. (via People Video),2016-06-19 03:00:00,video,161,66,9,236
25902406772,The anniversary of the legendary Kevin Garnett celebration.,2016-06-17 15:07:45,link,102,20,49,171
86680728811,U.S. Coast Guard rescues couple off the coast of Massachusetts after they were lost at sea in a small inflatable raft for over 12 hours.,2016-06-21 15:26:52,link,9,93,30,132
7245371700,"Beyoncé has fooled us all, again.",2016-06-15 21:14:41,link,116,17,45,178
112638779551,"A young Oakland Athletics fan did his best to spoil Colby Lewis' perfect game, and it may have worked.",2016-06-17 08:27:20,link,112,10,48,170
13652355666,A black bear cub climbed up a tree to avoid a herd of alpacas.,2016-06-21 17:35:00,video,159,55,41,255
52150999700,Modern Family star Ed O'Neill isn't going back to his '80s roots anytime soon.,2016-06-17 04:40:00,link,104,49,46,199
10513336322,"The pound's fall, which stunned investors, was its biggest ever one-day fall, and ranked with the reaction to the collapse of Lehman Brothers in 2008 and Britain's exit in 1992 from the European exchange rate mechanism on Black Wednesday.",2016-06-23 22:20:15,link,192,71,17,280
25902406772,The New York Knicks might try to snag Derrick Rose.,2016-06-17 16:28:24,link,98,55,6,159
25902406772,The Warriors season could go overlooked due to a GREAT finals performance.,2016-06-20 09:26:17,link,184,9,40,233
95926963131,"Saturday was all about North West's birthday celebration, but Sunday was all about Kanye West. (via People Babies)",2016-06-20 09:12:03,link,59,11,21,91
18807449704,OMG.,2016-06-21 23:27:18,link,148,74,29,251
7245371700,"PWR BTTM make it abundantly clear (and queer) which camp they strut in.

""Queer is invincible because people have tried everything — haven't they?"" Ben Hopkins says",2016-06-20 15:37:34,link,80,53,3,136
5281959998,"In one Facebook post, Omar Mateen raged against the ""filthy ways of the west."" In another, he warned of more attacks by ISIS ""in the next few days.""",2016-06-16 09:55:00,link,86,64,1,151
10513336322,Back to Earth with a thump.,2016-06-17 06:20:01,link,10,95,47,152
10513336322,"""Since the 1960s there have been rumors of sightings of blind, white catfishes in that area, but this is the first confirmation.""",2016-06-19 12:00:01,link,29,11,41,81
52150999700,It's official—the former Wonder Woman is heading to Supergirl! 👊🏼,2016-06-21 16:32:43,link,48,22,2,72
112638779551,The world's No. 1 golfer may not be on tour for as long as we hope.,2016-06-23 10:59:52,link,122,83,49,254
112638779551,"For months we've heard that Ben Simmons would rather play for the LA Lakers than the Philadelphia 76ers...

 But on Friday something happened... and now, all signs point to Simmons heading to Philly...",2016-06-17 13:55:09,link,52,7,47,106
5281959998,Hillary Clinton and President Bill Clinton are grandparents again.,2016-06-19 14:10:00,link,15,63,38,116
7245371700,"""I will be part of those masses of people. I will be whooping and hollering, celebrating self-love. But I will also be mourning our dead.""",2016-06-16 21:29:46,link,173,58,45,276
10606591490,"""I think profiling is something that we're going to have to start thinking about as a country,"" Trump said",2016-06-19 11:30:25,link,55,65,48,168
18807449704,"Is that you, Johnny Depp?",2016-06-19 04:00:00,link,186,42,29,257
5281959998,Standing up while working can help you burn about 8 or 9 extra calories per hour. That's all.,2016-06-22 07:25:00,link,66,31,12,109
95926963131,"Fred M. Caruso, a writer and producer best known for penning The Big Gay Musical, has reportedly died at age 41.",2016-06-15 18:14:07,link,146,20,10,176
7245371700,The ~rumors~ are true.,2016-06-23 20:58:55,link,2,17,31,50
5281959998,"Until now, no country has had its athletes barred from an Olympics for doping.",2016-06-17 16:55:00,link,89,47,7,143
95926963131,Vicki Gunvalson is not holding back on the new season of Real Housewives of Orange County.,2016-06-17 14:42:20,link,50,44,12,106
75932763901,Alyssa Milano's post-baby body looks incredible! Wait until you see her now after she lost 55 pounds (via Closer Weekly) —> http://bit.ly/1saRgdf,2016-06-24 06:45:00,photo,82,88,8,178
25902406772,LeBron James and Ben Simmons may just be a match made in heaven for the young star.,2016-06-18 17:09:59,link,63,21,44,128
18807449704,The BIGGEST bluetooth speaker ever  (and some sweaty headphones): #Unboxing,2016-06-22 12:14:19,video,44,71,17,132
86680728811,The clashes come on the heels of skirmishes between fans of the band Radiohead and police that occurred on Saturday in protest over an attack that took place at a record store on Friday night. http://abcn.ws/1UhyXty,2016-06-19 22:39:14,link,107,2,6,115
75932763901,She's GLOWING!,2016-06-15 19:30:00,link,168,65,11,244
10513336322,"""One question shouted louder than the others – was I the father?""",2016-06-18 08:40:00,link,60,33,29,122
10606591490,From Batman v Superman: Dawn of Justice to Dirty Grandpa.,2016-06-20 16:30:20,link,121,19,22,162
95926963131,The Zika virus isn't the only concern Rio de Janeiro faces before the Olympic Games.,2016-06-17 20:34:03,link,82,52,18,152
75932763901,HOW EMBARRASSING!! This famous lady suffered QUITE the wardrobe malfunction! (via Life & Style Weekly) —> http://bit.ly/1USPeau,2016-06-18 00:30:00,photo,72,74,49,195
25902406772,It should be a great ending at the U.S. Open Championship.,2016-06-18 14:08:33,link,14,91,43,148
112638779551,Stephen Curry was asked about his wife Ayesha's controversial tweets:,2016-06-18 16:46:11,link,147,25,15,187
5281959998,Milford Graves records people's heartbeats and uses that sound to make music. New York Today is in his New York studio to get a sample.,2016-06-17 10:36:25,video,44,59,45,148
52150999700,This new season of Big Brother will be the wildest YET! 😱 😁,2016-06-21 13:22:00,link,139,7,16,162
52150999700,American Gothic is the murder-mystery you MUST add to your summer TV lineup. 🙀,2016-06-22 22:02:34,link,89,55,34,178
75932763901,CONGRATS! Click here to find out what 21-year-old is rocking this impressive diamond on THAT finger... (via Life & Style Weekly) —>  http://bit.ly/28ShECo,2016-06-23 01:30:00,photo,82,16,29,127
10606591490,"Gwyneth Paltrow : It ""floats above the cobblestone streets like a pale, dreamy cloud.""",2016-06-16 21:00:13,link,186,27,36,249
7245371700,Is Katy Perry and Taylor Swift's feud still on?,2016-06-21 11:06:32,link,107,81,36,224
52150999700,Lin-Manuel Miranda is getting ready to take his final curtain call for Hamilton: An American Musical.,2016-06-22 14:31:51,link,182,39,29,250
52150999700,Bill Hader is the Star Wars droid we've been looking for!,2016-06-23 07:15:00,link,99,76,4,179
25902406772,GOODBYE SAD BROWNS QB JERSEY!,2016-06-20 18:43:37,link,137,67,10,214
7245371700,This may be my summer go-to jam.,2016-06-23 15:14:52,link,88,50,48,186
75932763901,Heartbreaking. Click here for Chris Brown's devastating confession —> http://bit.ly/28LuNxV,2016-06-21 23:30:00,photo,11,69,1,81
10606591490,Where does the word 'dad' come from?,2016-06-19 09:01:03,video,92,65,1,158
13652355666,It was only a matter of time.,2016-06-20 05:30:00,link,25,92,9,126
10513336322,DON'T PANIC.,2016-06-15 05:00:00,link,188,29,31,248
7245371700,Elizabeth Warren has been throwing down some very cutting words when addressing Donald J. Trump.,2016-06-20 14:37:24,link,93,56,37,186
112638779551,Dan Henderson says he'd love to knock out Official Michael Bisping one more time and then call it a career.,2016-06-15 11:23:02,link,64,19,40,123
25902406772,It should be an interesting NBA offseason.,2016-06-17 18:58:37,link,159,15,37,211
10606591490,Dwayne The Rock Johnson last ate a Twizzler in 1989.,2016-06-17 13:00:06,link,170,58,18,246
25902406772,"Don't forget about Kyrie Irving's clutch 3-pointer or Kevin Love's defense on Curry.

The Big 3 came up HUGE down the stretch.",2016-06-20 09:27:07,photo,150,41,43,234
10513336322,"Where did Bobby Gould insist Wales train in the buildup to their France 98 qualifiers?

•On Wimbledon Common, in front of hostile England fans
•Trecco Bay, once ranked as one of Wales's worst beaches
•HM Prison Usk
•In Cardiff city centre, in front of Welsh fans",2016-06-16 06:10:00,link,35,93,23,151
18807449704,*facepalm*,2016-06-18 17:01:00,link,179,1,42,222
13652355666,It was a daring rescue mission that helped save the lives of eight soldiers.,2016-06-22 00:35:00,link,163,52,12,227
86680728811,"Elizabeth Warren may seem like an exciting choice to some segments of Hillary Clinton's base, but the presumptive nominee stands to lose a deep-pocketed constituency by adding Warren to the ticket.",2016-06-22 19:38:24,link,23,8,5,36
7245371700,"What does it mean to be queer femme? 

In honor of Pride Month, here are more people like Shivani who embrace their true selves from #NoIDRequired: http://on.mtv.com/28TcGFF",2016-06-23 17:45:00,video,3,58,39,100
5281959998,"This was London, a week before one of the most critical political decisions in a generation.",2016-06-16 04:27:01,link,8,71,49,128
10606591490,"""Neither a person nor a photograph should be taken at face value.""",2016-06-20 13:30:12,link,89,25,34,148
18807449704,We're all wondering who will be the next big death in Game of Thrones.,2016-06-18 13:57:19,link,39,19,20,78
7245371700,"You tried, Blake Lively, you tried.",2016-06-22 19:00:08,link,136,2,30,168
75932763901,SHOTS FIRED. We wonder what Kim Kardashian West will think of what Paris Hilton just had to say... http://bit.ly/28PrDY5,2016-06-23 23:30:00,photo,131,99,43,273
25902406772,Stephen Curry's wife is not happy with the NBA.,2016-06-16 23:42:04,link,48,25,19,92
5281959998,"In the U.S. and Britain, a relatively normal electoral process became seized with populist nationalism, the Editorial Board writes in The New York Times Opinion Section.",2016-06-20 07:55:00,link,27,22,4,53
25902406772,Brice Johnson is trying to look NICE for the Draft.,2016-06-22 15:14:34,video,123,75,30,228
95926963131,Hats off to racegoers at the Royal Ascot! (via People Royals),2016-06-16 16:55:09,link,180,91,32,303
112638779551,Charles Barkley wasn't convinced by LeBron James' monster effort in the NBA Finals.,2016-06-23 07:30:47,link,173,17,17,207
10606591490,The shooter searched Facebook while he held hostages for hours.,2016-06-16 21:30:22,link,69,48,41,158
25902406772,LeBron James > Stephen Curry.,2016-06-16 22:54:01,link,115,61,8,184
112638779551,Who had the biggest win ever at the US Open? #betcha,2016-06-18 18:54:54,video,140,7,8,155
112638779551,Oakmont now knows when it will host its record 10th championship.,2016-06-18 12:18:44,link,148,36,16,200
95926963131,What Kim Kardashian West eats in a day (via People Great Ideas),2016-06-17 07:00:00,video,106,54,3,163
25902406772,Draymond Green rollin into Game 6 like...,2016-06-16 17:59:09,photo,117,25,5,147
18807449704,There's a groundbreaking gun-control sit-in happening right now but you can only see it on social media. Here's why.,2016-06-22 15:06:27,link,123,72,9,204
25902406772,Give the man some credit!,2016-06-15 20:18:58,link,138,86,18,242
10606591490,"Iggy Azalea: ""Futures can be rewritten and as of today mine is a blank page.""",2016-06-20 10:00:33,link,161,59,1,221
95926963131,"It looks like we'd need a roommate (or two, or three) to afford the How I Met Your Mother apartment! (via HelloGiggles)",2016-06-16 03:00:24,link,86,26,42,154
52150999700,You're going to need A LOT of tissues for Rachel Platten's moving tribute to the Orlando shooting victims. ❤️,2016-06-22 12:22:00,link,147,68,5,220
18807449704,A Democrat-led sit-in on the floor of the House of Representatives played out on social media when the cameras were turned off.,2016-06-22 23:43:32,link,20,78,20,118
13652355666,"""We were all in a state of shock.""",2016-06-17 05:08:01,link,178,50,46,274
112638779551,"Yes, those bottles are supposed to be on the field.

Nicole Dabeau for @TheBuzzer.",2016-06-15 17:26:50,video,142,88,8,238
52150999700,Susan Sarandon's tribute to the young Star Trek actor is incredibly touching.,2016-06-20 12:31:00,link,26,23,29,78
95926963131,Iggy Azalea is publicly splitting from fiancé Nick Young of the LA Lakers.,2016-06-19 22:53:09,link,22,79,45,146
25902406772,"""This bicycle ain't big enough for the two of us.""

""Well, actually...""",2016-06-17 16:29:33,link,45,49,35,129
10513336322,"John Oliver: ""Britain would be crazy to leave because, if it stays, it can reap all the benefits while still being a total dick about everything.""",2016-06-20 11:40:01,link,34,42,26,102
7245371700,It would be out of this world.,2016-06-22 21:47:18,link,146,73,40,259
5281959998,"A child played in an art installation by Darya von Berner titled ""Selfi"" at the Matadero Madrid, a center for contemporary art.

More photos of the week: http://nyti.ms/1UnV0RL

Photo: Javier Soriano/Agence France-Presse — Getty Images",2016-06-18 18:55:00,photo,195,82,1,278
10513336322,"""What world is white America living in? The statistics say it all. Half of black Americans who are born poor stay poor; black students attend the worst schools; 1.6 million black men aged 24-54 have disappeared from civic life because they have died or are in prison.""",2016-06-18 06:00:01,link,17,68,5,90
75932763901,RUDE! We can't believe Kim Kardashian West would be THIS selfish on daughter North West's birthday!! See the Instagram post that says A LOT about her personality 😒 –> http://bit.ly/1Yse5Fa,2016-06-15 20:30:01,photo,76,92,44,212
18807449704,THE ROBOT REVOLUTION BEGINS!,2016-06-17 14:01:25,link,112,73,6,191
5281959998,Double or even triple the cocoa. We won't tell.,2016-06-17 15:55:00,link,113,8,26,147
10513336322,"'Even when we look back and see how much our tastes have changed, the idea that we will change equally in the future seems to confound us. It is what keeps tattoo removal practitioners in business. Psychologists have identified the illusion that for many, the present is a ""watershed moment at which they have finally become the person they will be for the rest of their lives"".'",2016-06-22 07:00:00,link,39,27,14,80
25902406772,A look at some of the top NFL Draft prospects.,2016-06-16 14:26:05,link,104,87,17,208
10513336322,"""In June 2006, a 16-year-old girl began a video blog on YouTube. Her name was Bree, she was a self-described dork, she was funny, friendly, had great eyebrows. It soon became clear she was pretty lonely, which was probably why her username was Lonelygirl15. Her followers quickly ballooned and she became one of the young site's most popular stars. The New York Times had a recurring blog about her. She had her own forum. Hundreds of people wanted to be her friend on Myspace. The thing is, Bree wasn't real.""",2016-06-16 07:00:00,link,176,55,48,279
5281959998,A chant from some Mexican fans at the Copa América Centenario 2016 has proved controversial.,2016-06-17 18:25:00,link,183,4,26,213
7245371700,Selena Gomez's character has no chill.,2016-06-16 01:11:07,link,111,87,43,241
75932763901,Kim Kardashian West made waves when she posted these over-the-top Instagram pics — but they are NOTHING compared to little sister Kylie Jenner's latest post: http://bit.ly/1XjtlVo,2016-06-15 01:00:00,photo,7,4,27,38
112638779551,"The numbers don't lie. In these NBA Finals, Kyrie Irving > Stephen Curry",2016-06-16 14:10:49,link,91,5,22,118
112638779551,This is awesome.,2016-06-15 12:26:21,link,6,24,42,72
86680728811,Dark scenarios for the global economy are being discussed by economists as they try to gauge the risks of Thursday's referendum for the wider world. http://abcn.ws/21tI5PX,2016-06-19 15:46:21,link,122,5,28,155
18807449704,All the feels.,2016-06-20 18:00:00,link,198,61,14,273
10606591490,Donald J. Trump has said in the past that he would like Oprah Winfrey to be his running mate.,2016-06-17 16:30:24,link,112,87,50,249
18807449704,Demi Lovato returns to social media after 24-hour exit.,2016-06-22 19:10:18,video,23,61,19,103
86680728811,"UPDATE: DOJ and FBI release full transcript from Orlando shooter's 911 call to provide the ""highest level of transparency."" abcn.ws/28It1Ld",2016-06-20 13:52:31,link,128,18,30,176
95926963131,The twins' parents are doing the best they can following the tragedy. (via People True Crime),2016-06-23 15:00:54,link,82,57,15,154
13652355666,"A Colorado waiter was ""so happy"" — for a day.",2016-06-19 15:29:00,link,148,74,38,260
7245371700,The next generation of Spy Kids is in the making.,2016-06-18 17:27:09,link,91,73,7,171
112638779551,"After flying out, Adam Jones took out all of his frustration on his gum.",2016-06-23 11:32:45,link,179,15,4,198
7245371700,Bella Thorne takes you ~behind~ the scenes.,2016-06-15 15:51:52,link,132,91,43,266
86680728811,Former House Speaker Dennis Hastert to report to prison to begin serving 15-month sentence in hush-money case that revealed he sexually abused 4 boys decades ago.,2016-06-22 07:39:08,link,41,39,1,81
86680728811,"PHOTO: Orlando Mayor Buddy Dyer presents Pres. Barack Obama with an #OrlandoUnited shirt while greeting him at the airport. http://abcn.ws/1XsuKZO

The president and Vice President Biden spent the day in Orlando meeting with survivors, the families of victims and first responders.",2016-06-16 20:14:13,photo,78,24,3,105
95926963131,The wounded survivors of the horrific Orlando shooting speak out about the guilt and pain they're feeling.,2016-06-19 10:40:24,video,49,28,32,109
10513336322,"Paul Stevenson has had a life in trauma. The psychologist and traumatologist has spent 40 years helping people make sense of their lives in the aftermath of disaster, of terrorist attacks, bombings and mass murders, of landslides, fires and tsunamis. Now, he says, it is the Australian government deliberately inflicting upon people the worst trauma he has ever seen.",2016-06-20 01:20:00,link,50,58,26,134
25902406772,BELIEVE in U.S. Soccer.,2016-06-21 09:44:34,link,26,33,1,60
86680728811,"Transgender teen shares powerful message on bullying: ""We're not a threat. We are just like any other kids. We only want people to accept and love us for who we are."" http://abcn.ws/1Ub48qv",2016-06-16 10:32:59,video,192,12,45,249
7245371700,"""Westside the best side.""",2016-06-22 20:17:26,link,37,78,36,151
13652355666,In #TheShortList: How much hurt can Orlando handle?,2016-06-15 16:48:16,link,16,12,40,68
95926963131,Donald Trump's presidential campaign had just $1.3 million in the bank following a disastrous month of fundraising.,2016-06-21 18:14:04,link,49,59,7,115
10513336322,"How do you explain advertising to North Korea?

""When I said it's essentially propaganda for brands, the lights came on.""",2016-06-17 09:00:00,link,87,99,6,192
75932763901,NEW SAINT PICTURE! Kim Kardashian West's latest shot — featuring her daughter North AND son Saint — is too cute for words! 😍 http://bit.ly/28Jp22f,2016-06-20 12:30:00,photo,123,14,46,183
75932763901,CONGRATULATIONS!! Chelsea Clinton gives birth to her second child!! Find out the name here (via Closer Magazine) —> http://bit.ly/1V5cu2i,2016-06-18 12:45:00,photo,168,78,31,277
75932763901,OMG! Ashley Olsen was just spotted getting close to this man — who happens to be TWICE her age! Find out who —> http://bit.ly/1sGEaEy,2016-06-15 15:00:00,photo,73,65,37,175
7245371700,Keep them coming Kanye.,2016-06-18 06:25:39,link,79,31,39,149
10513336322,Steve Jobs is said to have once ate so many carrots that his skin turned orange. Here's how you can emulate him and other tech greats.,2016-06-23 03:00:00,link,113,45,18,176
10513336322,"""Women may be enormously distressed because the one thing they want in life is a baby: all their friends have one, they feel like outcasts from the best and biggest club in the world, they know all about their biological clock, and they don't need another expert dredging up more reasons why they shouldn't wait a minute longer to have one.""",2016-06-16 05:00:00,link,178,46,6,230
5281959998,"Nicholas Kristof is live, talking about his column on the Orlando shooting and gun control. You can read his column in The New York Times Opinion Section here: http://nyti.ms/1sHZlWL",2016-06-16 11:03:06,video,198,14,40,252
10513336322,"""We need a break before we are broken.""",2016-06-17 04:34:48,link,98,46,17,161
112638779551,"Dustin Johnson is making big moves in the world rankings after his win at the U.S. Open Championship! 

Kristen Balboni for @TheBuzzer",2016-06-20 16:31:33,video,23,87,7,117
13652355666,Happy National Ice Cream Soda Day!,2016-06-20 09:28:00,video,50,35,13,98
10513336322,"Jane Horrocks: ""I don't know if I wee'd a lot. Once I started I never knew how much was going to come out.""",2016-06-20 05:00:00,link,164,60,42,266
112638779551,Bryce Harper wrote a classy note to honor Los Angeles Dodgers legend Vin Scully.,2016-06-22 19:25:28,link,60,50,43,153
5281959998,"Seddique Mateen, the father of the Orlando shooter, invited The New York Times into his home to talk about Sunday's attack and his son. If you have questions for Mateen, please leave them in the comments.",2016-06-15 12:19:19,video,53,21,28,102
25902406772,This announcer was HYPE.,2016-06-22 15:08:19,link,174,35,50,259
10606591490,"Jewel: ""I'm calling out the backstabbers and gossips who turn on their sisters.""",2016-06-23 10:00:23,link,133,31,14,178
7245371700,This would be a refreshing pair in the male-dominated Westeros.,2016-06-21 04:58:39,link,181,19,33,233
7245371700,"How could you, OITNB?",2016-06-23 02:21:29,link,182,81,34,297
7245371700,Mika Boorem remembers Anton Yelchin ❤️,2016-06-21 11:53:30,link,93,6,18,117
13652355666,"""You protect your kids as best as you can. They reach an age where they can run around and play. How do you defend against everything?""",2016-06-20 20:50:00,link,174,41,50,265
7245371700,The Flash even has Batman's heart.,2016-06-21 12:58:25,link,96,6,4,106
112638779551,"Neymar Jr. pulls off a trick shot, then challenges Ronaldo.

Nicole Dabeau for @TheBuzzer.",2016-06-15 01:34:03,video,65,91,23,179
18807449704,These new photos will rekindle your obsession for 'Hot Felon.',2016-06-15 13:20:16,link,108,65,46,219
10606591490,"""One of the most successful ways to raise drug awareness is to show substances' harrowing impact on a user's face over time.""",2016-06-23 08:00:56,link,184,88,49,321
10513336322,"The key information about Omar Mateen, the American of Afghan origin who killed 49 people in Orlando, Florida, in the deadliest mass shooting in modern US history. The 29-year-old was previously investigated by the FBI but authorities have played down claims that he was directed by a foreign terrorist network",2016-06-15 13:00:01,video,191,31,29,251
52150999700,"Get ready for a whole lot more of The Flash, Supergirl, and Supernatural!!!",2016-06-17 13:06:05,link,180,49,21,250
86680728811,Watch as a U.S. Army soldier who has been deployed since October surprises his two children at an elementary school in Virginia.,2016-06-17 12:53:05,video,92,99,45,236
52150999700,"Rory Gilmore saw Barack Obama into the White House, but is she planning on seeing him out too?",2016-06-22 20:38:00,link,56,13,20,89
52150999700,Supergirl has found its Superman in a Teen Wolf star! 👊🏼,2016-06-18 11:51:00,link,139,64,6,209
86680728811,Police in Louisiana are investigating how two 3-year-olds found unresponsive in a pickup truck ended up there.,2016-06-20 20:18:35,link,35,16,19,70
7245371700,"""In 2016, everyone can benefit from behaving in a better, more loving way.""",2016-06-19 11:49:04,link,54,80,34,168
112638779551,"To prepare for Round 2 of the U.S. Open Championship, Bubba Watson got some help from his son. 

Kristen Balboni for @TheBuzzer",2016-06-17 17:39:14,video,33,51,23,107
112638779551,The 2016 NBA Draft is right around the corner. Here's what you should be hoping your favorite team does tonight.,2016-06-23 15:35:57,link,117,21,37,175
7245371700,No one's immune to a mean Instagram comment.,2016-06-22 03:09:21,link,167,99,5,271
112638779551,"Bubba Watson almost made a scary kind of birdie

Kristen Balboni for @TheBuzzer",2016-06-19 19:49:46,video,158,25,24,207
18807449704,#BizPlease is LIVE with Ted Leonsis chatting about the sports internet.,2016-06-15 14:43:06,video,84,46,17,147
86680728811,"""We lack confidence that Judge Persky can fairly participate in this upcoming hearing in which a male nurse sexually assaulted an anesthetized female patient."" - Santa Clara County District Attorney Jeff Rosen",2016-06-15 22:01:07,link,173,47,38,258
25902406772,The Cleveland Cavaliers will celebrate their accomplishments accordingly.,2016-06-20 00:43:46,link,93,25,15,133
25902406772,Real recognize real.,2016-06-16 23:21:04,link,46,5,26,77
7245371700,Can you believe that was almost 13 years ago?,2016-06-18 07:45:50,link,67,75,15,157
10606591490,Elon Musk is at it again.,2016-06-22 03:00:17,link,180,96,25,301
112638779551,Zlatan Ibrahimovic says he will retire from international play after Euro 2016.,2016-06-21 10:16:32,link,30,29,6,65
5281959998,The English have (kind of) been here before.,2016-06-20 13:25:00,link,89,52,42,183
112638779551,Dennis Rodman had a Hall-of-Fame NBA career. An NAIA coach convinced the bizarre superstar he had what it takes.,2016-06-21 08:34:17,link,162,28,28,218
75932763901,Ummm... GROSS! See who had this embarrassing mishap on stage! –> http://bit.ly/1rZo48B,2016-06-20 22:30:00,photo,194,43,42,279
75932763901,"""He beats me. He's going to kill me."" This famous actress was rushed to the hospital after having a scary breakdown in front of her 4-year-old son —> http://bit.ly/28NXVDT",2016-06-21 22:30:00,photo,162,47,42,251
5281959998,"Einstein, right again: Astronomers have detected a second pair of black holes that devoured each other in a collision.",2016-06-15 16:25:00,link,2,36,24,62
52150999700,Fast & Furious star Vin Diesel revealed his geeky side in this sweet video. 😂❤️,2016-06-16 18:40:00,link,46,46,25,117
95926963131,The lack of an alligator warning at Disney shocked several tourists at the Hyatt.,2016-06-17 11:24:06,link,142,69,2,213
52150999700,The blink-182 member is supposedly pulling double duty as a government agent... 👽,2016-06-22 07:30:01,link,185,68,41,294
86680728811,"Orlando gunman had visited the Pulse nightclub and left before returning with an assault rifle and opening fire there, killing 49 people and injuring dozens of others, police said.",2016-06-21 17:14:33,link,162,49,14,225
10606591490,Hint: It's not the U.S.,2016-06-18 08:00:55,link,180,57,10,247
75932763901,Kim Kardashian West makes sexual confession about Kanye West — and some people think it's WAY too much information!—> http://bit.ly/21mHO1d,2016-06-15 12:30:00,photo,88,68,23,179
86680728811,"Donald J. Trump: ""Hillary Clinton has perfected the politics of personal profit and even theft."" http://abcn.ws/28TRgWs",2016-06-22 09:54:38,video,199,33,13,245
13652355666,"Omar Mateen's wife, Noor Salman, could be charged as an accessory to 49 counts of murder and 53 counts of attempted murder.",2016-06-15 09:58:00,link,77,18,49,144
95926963131,"When Blake Lively needed advice for her upcoming thriller The Shallows, she didn't have to look far.",2016-06-22 13:15:06,link,88,93,38,219
13652355666,"Now, that's a dependable Facebook friend.",2016-06-21 12:19:00,link,153,80,27,260
10606591490,Would you take a nap at work?,2016-06-17 15:30:23,link,89,45,39,173
10606591490,You might want to start cleaning the dishes.,2016-06-22 15:30:11,link,77,20,31,128
95926963131,Brandi Glanville is opening up about the emotional fallout of her ex-husband's affair.,2016-06-20 15:50:07,link,58,38,25,121
75932763901,"Kim Kardashian West CAUGHT wearing the exact same outfit as another famous star – when you see who, you'll understand why it was so AWKWARD –> http://bit.ly/1rpUyc0",2016-06-19 00:45:00,photo,125,35,10,170
112638779551,Fedor Emelianenko earned a very controversial decision on Friday but is that enough to land him with the UFC finally?,2016-06-17 16:54:36,link,122,6,21,149
95926963131,Mara Wilson is standing in solidarity with the LGBT community in a big way.,2016-06-15 07:22:02,link,133,2,33,168
25902406772,A magical display from Leo Messi and Co. has Argentina in the Final.,2016-06-21 22:03:14,photo,90,17,6,113
18807449704,This teenage monkey is all about her makeup. 🐵💁,2016-06-24 03:00:00,video,199,99,24,322
75932763901,She's HUGE!,2016-06-24 06:00:00,link,19,82,27,128
86680728811,"Donald J. Trump is making new efforts to reach out to Christian voters, holding a private meeting with religious leaders to recommend they pray to get ""everybody out to vote.""",2016-06-22 01:21:04,link,145,44,36,225
86680728811,"UPDATE: DOJ and FBI release full transcript from Orlando shooter's 911 call to provide the ""highest level of transparency."" abcn.ws/28It1Ld",2016-06-20 10:01:25,link,149,15,40,204
25902406772,Good news for the Golden State Warriors.,2016-06-18 16:12:02,link,186,27,48,261
75932763901,"First comes love, then comes marriage... Click here for Teen Mom 2 stars Chelsea and Cole's BIG NEWS! —> http://bit.ly/28IYw6i",2016-06-21 06:00:01,photo,200,33,27,260
10513336322,"Asked if she was a feminist, she said: ""Now, I am.""",2016-06-20 06:40:01,link,29,86,7,122
13652355666,Spoiler(s) alert!,2016-06-20 16:18:20,link,148,4,16,168
5281959998,"Facing sexism with exhaustion — and humor.

(via The New York Times Books)",2016-06-17 12:40:00,link,122,87,33,242
52150999700,"While Walter Koenig only met Anton Yelchin once, the late actor made a strong impression on him.",2016-06-20 20:57:10,link,196,93,16,305
75932763901,NEW SAINT PHOTO! How cute are Kim Kardashian West's two kis?! See the latest shot —> http://bit.ly/28Jp22f,2016-06-20 23:30:01,photo,159,87,32,278
52150999700,The studio behind the Star Trek reboot has issued a statement on the actor's death.,2016-06-19 15:59:59,link,21,96,4,121
10606591490,So much for empty nests.,2016-06-19 04:30:06,link,30,51,28,109
5281959998,The United States Air Force said there was no harmful radiation at the crash site. Now many men are sick or dead.,2016-06-19 09:10:00,link,95,61,40,196
10513336322,"""Those suffering domestic abuse need swift and effective support. The number one issue should always be safety. ""Are you safe?"" should be a question asked by every police officer and prosecutor dealing with a domestic abuse case. Those lessons now need to be taken to the world of work – this is the next frontier.""",2016-06-17 05:20:00,link,166,77,47,290
5281959998,"""Maybe I'm naïve. Maybe I'm just waiting to be victimized. I'd rather be naïve and hopeful than face the alternative,"" writes Nate Bethea, who served as a United States Army infantry officer.",2016-06-16 14:55:00,link,82,19,32,133
13652355666,Clinton and a joint fundraising committee she established with the DNC raised a combined $28.2 million in May.,2016-06-21 01:40:00,link,60,24,23,107
52150999700,The new trailer for Miss Peregrine's Home for Peculiar Children is truly magical.,2016-06-20 09:52:16,link,147,33,2,182
86680728811,"Los Angeles-bound flight diverted to Tucson following a 'verbal disturbance' involving a passenger, FBI confirms.",2016-06-22 23:31:23,link,187,42,32,261
10606591490,"It's possible that the gig economy could give more power to workers, TIME's Rana Foroohar writes",2016-06-15 17:30:08,link,30,72,14,116
95926963131,"Matthew McConaughey is our #1 reason to love America! Inside his candid interview about his early years, raising his family and his amazing journey from Texas to Hollywood in this week's PEOPLE cover story: http://peoplem.ag/nLBW1Fx",2016-06-22 07:07:01,photo,45,33,27,105
25902406772,"The ""NBA is rigged"" hot takes having been heating up.",2016-06-17 13:26:42,link,136,10,5,151
5281959998,An internal investigation by the U.S. Marine Corps has concluded that for more than 70 years it wrongly identified one of the men in the iconic photograph of the flag being raised over Iwo Jima during one of the bloodiest battles of World War II.,2016-06-23 05:55:01,link,77,87,25,189
25902406772,Looking for a center? We got you covered.,2016-06-18 16:05:34,link,45,30,14,89
112638779551,Andrew Johnston is having the most fun at the U.S. Open Championship. Don't believe us? Check out how he's passing time during a rain delay. PROcast,2016-06-16 19:55:12,video,15,18,43,76
112638779551,"UFC president Dana White has a few words to address Donald ""Cowboy"" Cerrone's complaints about his paycheck",2016-06-21 17:31:49,link,133,96,30,259
10513336322,"""It's difficult to pinpoint the exact moment when I realised he wasn't like other dads, but it might have been when I was off school ill and he bought me a comic. 'What's the duck doing to the lady?' I asked. Howard the Duck was mounting a naked woman with naked breasts. 'Playing,' he said, confiscating it.""",2016-06-18 11:20:00,link,39,84,20,143
10513336322,"Arnold Schwarzenegger: ""Less meat, less heat, more life.""",2016-06-23 13:20:00,link,103,92,37,232
7245371700,Meet French rap duo PNL whose distinctive sound and political specificity transcends any language barrier. (via The FADER),2016-06-15 14:27:07,link,178,43,20,241
52150999700,These epic new Game of Thrones photos show Westeros' biggest battle yet! 😱,2016-06-15 12:44:07,link,120,20,5,145
52150999700,That Game of Thrones death was one of the most satisfying—and gruesome—in the show's history. 😱,2016-06-19 21:09:13,link,164,33,8,205
25902406772,More hardware getting handed out in the NHL.,2016-06-22 20:43:59,link,22,1,27,50
10606591490,"""You don't need more info. You need the right info.""",2016-06-21 10:00:19,link,165,16,43,224
7245371700,I missed this look.,2016-06-17 01:48:45,link,132,38,17,187
10513336322,"""Most Brits aren't here because they're convinced Europeans. They're here because houses are cheap, the sun shines, the wine is good … Some have been here for 20 years and they still don't really speak the language. They call themselves expats but they're immigrants really, of course, like so many of us. But they don't always see it that way.""",2016-06-22 04:20:01,link,46,51,32,129
95926963131,PeopleStyle is LIVE playing Kylie Jenner Lip Kit roulette!,2016-06-23 15:45:46,video,187,88,16,291
75932763901,We are SO happy for Teen Mom 2 star Jeremy Calvert — but we wonder how Leah Messer will react to this shocker: http://bit.ly/28ZJwn3,2016-06-23 11:30:01,photo,13,4,17,34
25902406772,Cristiano Ronaldo and Portugal failed to win yet again.,2016-06-18 16:58:54,link,188,25,1,214
7245371700,"And her baby pic is adorable, too.",2016-06-19 19:19:41,link,23,17,39,79
7245371700,Admiring Arya a little more considering what she pulled off.,2016-06-18 20:32:03,link,158,1,16,175
25902406772,RJ is going out a champion.,2016-06-20 00:04:36,link,62,56,23,141
75932763901,"Tom Cruise's daughter, Suri, is all grown up — and looks JUST like her famous dad! See her latest photo (via Closer Weekly) —> http://bit.ly/28JsUgx",2016-06-20 23:00:00,photo,40,57,12,109
52150999700,Game of Thrones just can't be stopped. 🔥 🔥 🔥,2016-06-23 09:35:44,link,11,25,6,42
10513336322,Independence Day: Resurgence – In space no one can hear you yawn.,2016-06-21 11:20:01,link,168,70,13,251
13652355666,"""I'm a very intense person.""",2016-06-21 00:16:00,link,147,20,45,212
5281959998,"Can the Golden State Warriors repeat, or will the Cleveland Cavaliers win their city's first major sports title since 1964?",2016-06-19 20:14:25,link,13,84,14,111
52150999700,"The Ghostbusters cast say watching the reboot will ""shut everybody up!""",2016-06-18 14:11:00,link,93,55,10,158
52150999700,Gilmore Girls superfan Sutton Foster couldn't leave the set without a souvenir! (via HelloGiggles),2016-06-16 00:21:00,link,65,96,23,184
7245371700,Nothing like expensive baby clothes to make 2 Chainz smile.,2016-06-22 11:54:53,link,79,34,33,146
112638779551,"Oh no....

Shaquille O'Neal wants everyone to know he is the real 'Unaminous' MVP",2016-06-22 00:44:34,link,100,1,33,134
25902406772,Let the summer of Kevin Durant begin.,2016-06-21 10:40:02,link,89,31,19,139
13652355666,Where a kid can be a kid.,2016-06-21 10:47:00,link,54,49,4,107
13652355666,They were voted as the best sandwiches in America in round two of USA TODAY 10Best's sandwiches contest.,2016-06-18 10:10:00,video,20,64,23,107
52150999700,"J.K. Rowling has a beautiful vision for Newt Scamandar in the Fantastic Beasts Movie, Harry Potter fans! 😱 ❤️",2016-06-23 10:41:00,link,33,61,11,105
10606591490,"Justin Bieber called the site ""untruthful and hurtful.""",2016-06-15 13:01:00,link,65,20,20,105
10513336322,A quarter of the children surveyed had paid for fast food to be delivered to the school gates.,2016-06-23 02:20:01,link,188,70,14,272
13652355666,Almost all is right in the world again. Almost.,2016-06-20 07:03:25,link,169,100,31,300
10513336322,Can Nintendo redefine The Legend of Zelda for the open-world age?,2016-06-16 05:50:00,link,141,42,21,204
86680728811,"A small plane crash-landed on top of a warehouse in Houston, Texas, causing minor injuries to the pilot and heavy damage to the aircraft after the plane ran out of fuel.",2016-06-20 21:46:54,link,87,94,21,202
5281959998,"Bernie Sanders stood at a podium in a small, chilly TV studio and insisted he is fighting on.",2016-06-16 23:12:37,link,40,44,14,98
5281959998,Why is Hillary Clinton holding up so well against Donald J. Trump? Read on from Paul Krugman in The New York Times Opinion Section.,2016-06-20 20:25:00,link,9,61,6,76
7245371700,"Happy birthday to the OG, Ice Cube!",2016-06-15 17:30:15,link,181,33,46,260
10606591490,"J.K. Rowling: ""I don't think I've ever wanted magic more.""",2016-06-24 03:30:13,link,4,62,13,79
75932763901,Kim Kardashian West made waves when she posted these over-the-top Instagram pics — but they are NOTHING compared to little sister Kylie Jenner's latest post: http://bit.ly/1XjtlVo,2016-06-18 09:00:00,photo,81,13,5,99
13652355666,Baltimore Officer Caesar Goodson Jr. had faced the most serious charge leveled against any of the officers charged for the death of Freddie Gray. usat.ly/28SkKrw,2016-06-23 15:35:00,video,31,89,8,128
7245371700,Chat with the cast of MTV2's Guy Code vs. Girl Code!,2016-06-23 15:10:51,video,32,45,32,109
52150999700,J.K. Rowling sent an emotional and heartfelt message. ❤️,2016-06-18 15:49:00,link,21,98,27,146
7245371700,Almost all of my favorite Disney + Nickelodeon stars have been on Broadway.,2016-06-19 03:47:47,link,151,86,22,259
25902406772,Picking a starter is going to be TOUGH.,2016-06-22 13:24:33,link,30,56,18,104
86680728811,"Led Zeppelin guitarist Jimmy Page testified that, until a few years ago, he'd never heard the song that he's accused of ripping off.",2016-06-16 00:05:07,link,175,87,21,283
25902406772,"LeBron James will be staying home, folks.",2016-06-22 11:16:18,link,77,71,48,196
5281959998,"Angelika Graswald said she felt ""trapped"" and had withheld her fiancé's paddle after his kayak capsized, an investigator testified.",2016-06-20 19:55:00,link,73,61,37,171
86680728811,President Barack Obama and Vice President Biden will travel to Orlando today to meet with the families of victims and first responders. http://abcn.ws/1rrSBLr,2016-06-16 07:51:35,link,54,27,33,114
86680728811,"NEW: Walt Disney World ""devastated and heartbroken"" after death of 2-year-old boy from alligator attack. http://abcn.ws/1XXQrlq",2016-06-15 16:22:43,photo,72,39,20,131
7245371700,Wise words from Eric Matthews's beloved alter ego.,2016-06-17 17:54:33,link,38,11,12,61
5281959998,"""He didn't even charge me for the ride!""",2016-06-17 17:55:00,link,67,62,46,175
5281959998,"A masked, armed assailant attacked a movie theater in Viernheim, Germany, and was killed by elite police units that stormed the building.",2016-06-23 10:22:54,link,74,39,6,119
5281959998,22 satisfying dishes.,2016-06-19 13:40:08,link,65,45,7,117
13652355666,It's a miracle the 6-year-old boy is safe.,2016-06-17 11:45:01,video,190,44,8,242
86680728811,"Video recorded earlier this month appears to show an alligator in Disney's Grand Floridian Seven Seas Lagoon, where a 2-year-old boy was killed by a gator on Tuesday. http://abcn.ws/263UJZn

The person who posted the video said they didn't alert Disney because ""we did not think it was anything out of the ordinary. It is Orlando,  Alligators are common.""",2016-06-15 21:31:41,video,86,29,31,146
10513336322,"""Look up – a rainbow! Look down – another one there on the ground, where yesterday was just a patch of spilled oil! """,2016-06-15 08:30:00,link,21,55,2,78
52150999700,Zenon: Girl of the 21st Century almost became a Disney TV series—and still could (!!!!).,2016-06-22 14:52:00,link,94,39,40,173
112638779551,Dallas Mavericks owner Mark Cuban plans to donate $1 million to the Dallas Police Department to help protect the LGBT community days after the attack in Orlando.,2016-06-15 22:28:54,link,34,44,21,99
5281959998,Breaking News: The Supreme Court rejected a challenge to race-conscious admissions in Texas — a major win for affirmative action supporters.,2016-06-23 09:25:44,link,7,57,46,110
52150999700,Game of Thrones just pulled off the greatest battle sequence in TV history. 🙌,2016-06-19 21:32:27,link,176,92,29,297
10606591490,Feeling hungry?,2016-06-21 14:30:53,link,94,94,8,196
5281959998,Barely had the shooting stopped when a furious battle to claim the victims began.,2016-06-20 11:25:00,link,102,57,6,165
7245371700,"Bars + clubs serve as safe spaces for many marginalized groups — but shouldn't these spaces take specific action to provide bodily safety, too?",2016-06-15 12:45:48,link,191,95,20,306
52150999700,Sansa Stark FINALLY gave Game of Thrones fans what they wanted all along. 😱,2016-06-20 08:36:00,link,93,2,40,135
7245371700,"Here's what you 'Need to Know' on 6/15 from Lil Wayne, ScHoolboyQ, and Khloé Kardashian.",2016-06-15 05:24:34,video,140,82,24,246
18807449704,Can we talk about Beyoncé's side-eye game?! 🔥,2016-06-21 12:45:00,link,31,82,5,118
25902406772,"After winning a title for Cleveland, LeBron James channeled a familiar meme.",2016-06-20 18:04:56,photo,79,46,15,140
10606591490,The AR-15 has become the centerpiece of the gun control debate.,2016-06-16 22:00:08,link,72,29,30,131
52150999700,"The first teaser for Ava DuVernay and Oprah Winfrey's new series, 'Queen Sugar' does NOT disappoint.",2016-06-22 22:13:00,link,48,80,46,174
75932763901,WHOOPS! Megan Fox's dad accidentally revealed the gender of baby No. 3! Find out what she's having —> http://bit.ly/28W5lVo,2016-06-24 11:30:01,photo,16,51,26,93
10606591490,There's a reason why feeding alligators is illegal in the state of Florida.,2016-06-15 14:00:04,link,50,45,33,128
10513336322,One of the world's biggest sports star will not appear at this summer's Olympics.,2016-06-23 18:40:01,link,198,42,42,282
112638779551,"While Cleveland fans celebrate the Cavs title, a former Cleveland Browns player brings them back down to earth.",2016-06-22 16:35:49,link,90,44,14,148
18807449704,"Watch James Corden take Carpool Karaoke to new heights, literally, with Selena Gomez.",2016-06-21 13:00:01,link,59,12,13,84
7245371700,Anton Yelchin's Star Trek co-stars have heartbreaking reactions to the passing of their friend.,2016-06-19 15:30:23,link,84,94,31,209
7245371700,Bella Thorne is rocking a bold new look.,2016-06-20 12:04:11,link,19,56,46,121
95926963131,A Massachusetts mom believes these chilling photos of her 3-year-old son splashing in the water were taken just minutes before tragedy struck.,2016-06-16 12:54:30,link,57,12,9,78
95926963131,Twitter is not quite sure how to handle Taylor Swift and Tom Hiddleston's steamy new photos.,2016-06-15 18:36:24,link,128,79,35,242
75932763901,BAD PARENTING?! Ice T and Coco's recent parenting choice has some fans seriously MAD! –> http://bit.ly/1Qs4gQ1,2016-06-20 06:00:00,photo,200,69,39,308
86680728811,"President Barack Obama  and Vice President Biden will travel to Orlando Thursday to meet with victims' families, The White House says. http://abcn.ws/1XXGwfA",2016-06-15 14:51:27,photo,45,43,21,109
86680728811,Remembering the victims of the Orlando shooting. http://abcn.ws/1XrxB5g,2016-06-16 10:05:00,photo,171,2,48,221
112638779551,"Johnny Cueto had an eventful, yet effective, day on the mound for the San Francisco Giants.",2016-06-16 10:31:58,link,21,24,7,52
10606591490,1. Listen to music from the happiest time in your life.,2016-06-17 20:01:08,link,38,18,28,84
112638779551,The Carolina Panthers tackle has bristled at the ongoing jokes in the past but he's enjoying these.,2016-06-17 10:27:50,link,171,24,4,199
52150999700,"Christina Aguilera co-wrote the incredibly moving new song called ""Change.""",2016-06-17 07:06:00,link,45,6,31,82
25902406772,Cleveland Cavaliers guard JR Smith's daughter is just being honest.,2016-06-16 19:34:58,link,180,75,14,269
13652355666,BREAKING: It's official. The International Olympic Committee has backed down.,2016-06-21 10:27:17,link,98,20,25,143
5281959998,The governor of Istanbul banned LGBT individuals from holding pride parades at their usual venue.,2016-06-17 14:55:00,link,52,56,35,143
7245371700,Who knew Kendall Jenner was so creative?,2016-06-23 14:01:40,link,167,40,23,230
13652355666,Donald J. Trump is trying to get back on track with a familiar tactic.,2016-06-22 07:21:00,link,137,98,3,238
112638779551,The situation continues to get uglier at Baylor.,2016-06-15 15:59:02,link,76,96,41,213
18807449704,They're packing their bags and they're never coming back!,2016-06-24 05:03:43,link,33,33,36,102
86680728811,"Talk about a wet commute. After a storm moved through, Washington DC Metro riders had to wade through the flooded Cleveland Park station as they went about their business. http://abcn.ws/28MdOtx",2016-06-21 19:08:37,video,6,59,22,87
5281959998,"""Listen,"" LeBron James said, ""at the end of the day, I go out every single night and give everything I've got to the game. The game has always given back to me. So I'm OK with whatever.""",2016-06-19 18:25:00,link,197,87,23,307
10606591490,"""You protect your kids as best as you can. How do you defend against everything?""",2016-06-20 18:30:17,link,149,59,3,211
75932763901,Have you ever noticed Dorothy's hair changes length throughout 'The Wizard of Oz'? See 7 more shocking mistakes from your favorite movies (via Closer Weekly) —> http://bit.ly/1XNivWy,2016-06-18 13:15:00,photo,132,10,34,176
10606591490,Don't try this at home.,2016-06-23 02:00:40,link,97,59,34,190
13652355666,#BREAKING: Gunman injures up to 50 people in German cinema.,2016-06-23 10:06:59,link,143,63,15,221
52150999700,'Spider-Man: Homecoming' continues to weave its casting web.,2016-06-21 21:02:00,link,29,26,50,105
95926963131,Make your reservations asap because six restaurants from the U.S. made the list! (via People Great Ideas),2016-06-18 06:00:39,link,46,68,10,124
5281959998,"""Today, some of our politicians and the people who back them seem to promote a culture of gun ownership that does not conform with what I learned in the military,"" Gen. Stanley McChrystal writes in The New York Times Opinion Section.",2016-06-16 20:25:00,link,27,15,15,57
52150999700,"Our Hufflepuff hero Newt Scamander is ready for ANYTHING in Fantastic Beasts Movie, Harry Potter fans! ✨",2016-06-20 10:37:07,link,27,64,47,138
112638779551,"Stephen Curry was fine in Game 6, but he hasn't looked like an MVP in the NBA Finals.",2016-06-17 07:00:00,link,146,25,12,183
25902406772,The Golden State Warriors were soooooo close to beating the game.,2016-06-19 21:38:28,video,125,46,11,182
75932763901,PREGNANT! This celebrity couple just revealed they're expecting their first child together! See who —> http://bit.ly/1Yuf1ZO,2016-06-16 12:30:00,photo,139,22,5,166
75932763901,Remember Mia's love Michael from 2001's 'The Princess Diaries'? JUST WAIT until you see what he looks like now (via Closer Weekly) —> http://bit.ly/1M59TYc,2016-06-17 05:30:00,photo,63,66,8,137
7245371700,Just another reason to love Carpool Karaoke.,2016-06-16 00:14:38,link,160,88,21,269
18807449704,"For now, Apple Inc. is no longer in the external monitor business.",2016-06-23 20:07:27,link,81,5,28,114
95926963131,"Will Reeve is finally opening up about what it was like growing up having the late, legendary Christopher Reeve as a father.",2016-06-19 17:14:27,video,93,49,49,191
7245371700,Time to start sleeping with the lights on.,2016-06-20 11:11:23,link,160,5,19,184
18807449704,Kim Kardashian West is just like us!,2016-06-17 15:45:01,link,20,72,16,108
95926963131,This poor little cat was in the wrong place at the wrong time! (via PEOPLE Pets),2016-06-18 01:00:19,link,60,4,23,87
75932763901,THE CLAWS ARE OUT! Blac Chyna has strict rules for Kim Kardashian West to follow at her upcoming wedding — and now we wonder if she'll even show up: http://bit.ly/28Scqpz,2016-06-24 13:00:00,photo,199,81,1,281
112638779551,Follow U.S. Open Championship updates all weekend long with the all new FOX Sports App.,2016-06-17 11:19:26,link,95,80,31,206
5281959998,"The plaintiffs said the Starbucks drinks were underfilled by about 25% of their advertised sizes: 12, 16 and 20 ounces.",2016-06-21 16:55:00,link,166,44,18,228
86680728811,Philadelphia becomes the first major American city to approve a soda tax despite a multimillion-dollar campaign by the beverage industry to block it. http://abcn.ws/1Un0aNG,2016-06-17 08:08:55,link,108,86,6,200
10606591490,1. Own your story. There's power in embracing your vulnerabilities and pain.,2016-06-15 00:00:13,link,123,11,35,169
7245371700,My eyes have definitely opened up more to who Justin Bieber is as a person.,2016-06-15 14:53:44,link,119,28,50,197
5281959998,"The last coal mine closed a decade ago, but this county may soon be home to the largest wind farm in North America, if not the world.",2016-06-19 17:55:00,link,28,93,19,140
7245371700,Looks like Kim Kardashian West has major evidence against Taylor Swift.,2016-06-16 11:27:58,link,176,48,39,263
52150999700,Captain America is NOT here for the right reasons... 😂,2016-06-21 08:56:00,link,77,31,41,149
25902406772,DJ is the KING of golf right now.,2016-06-21 12:01:39,link,12,55,9,76
10606591490,This robot can slice us all to bits.,2016-06-19 02:30:06,link,189,93,12,294
18807449704,Beautiful!,2016-06-18 03:00:00,link,58,30,31,119
52150999700,It's morphin' time! The brand new Power Rangers poster is truly awesome. 👊🏼,2016-06-22 09:56:00,link,123,29,11,163
112638779551,"""I was about to quit, but then I kept on going."" — James Savage",2016-06-15 22:45:55,link,112,76,13,201
13652355666,What an amazing story.,2016-06-21 21:30:00,link,176,74,18,268
86680728811,"""They are in control of a portion of the city...there's still a lot of fighting to be done, "" Secretary of Defense Ash Carter says. http://abcn.ws/1XZIex9",2016-06-17 15:03:04,link,45,18,46,109
5281959998,A U.S. Senate panel has asked officials at the world doping watchdog to explain its handling of the Russia case.,2016-06-20 10:26:16,link,12,93,17,122
112638779551,Stephen Wonderboy Thompson is calling for a UFC title shot against champion Robbie Lawler,2016-06-19 02:56:51,link,67,74,47,188
13652355666,BREAKING: Democrats end their sit-in to protest gun violence,2016-06-23 12:25:04,link,16,63,43,122
86680728811,Daughters star in Switzerland-based photographer John Wilhelm's quirky photo creations: http://abcn.ws/1ScLoEH,2016-06-19 16:58:55,video,75,100,44,219
5281959998,"""The motive of Jo Cox's killer will become clearer in the weeks to come. But it shouldn't take the death of a politician to alert us to the dangers of the politics of hate,"" Daniel Trilling writes in The New York Times Opinion Section.",2016-06-17 23:55:00,link,164,59,10,233
25902406772,Uncovering who would be in the USC Trojan Football's Mt. Rushmore.,2016-06-17 09:04:00,link,182,34,18,234
10606591490,"""Every guest he came across, he created a magic for them that can never be compared to anything in this world.""",2016-06-15 12:00:36,link,121,25,46,192
7245371700,"Who lives, who dies, who takes Winterfell on Game of Thrones?",2016-06-19 17:45:06,link,20,64,40,124
95926963131,The Bachelorette recap and Ny Times bestselling author Jennifer Weiner takes on YouTube's Roast Yourself challenge! (via People Video),2016-06-22 03:00:00,video,14,88,16,118
112638779551,The U.S. were overwhelmed by Argentina in the Copa America semifinal Tuesday.,2016-06-21 22:25:13,link,66,72,15,153
10606591490,Nude women will hold mirrors facing the site of the Republican National Convention.,2016-06-17 12:30:11,link,87,4,33,124
112638779551,See the Sacramento Kings' new uniforms for the next NBA season,2016-06-15 14:35:07,link,117,41,11,169
5281959998,"If regional leaders fail to take a strong and united stand against President Nicolás Maduro, Venezuela's crisis can only be expected to grow. Read on in The New York Times Opinion Section.",2016-06-21 03:55:00,link,74,72,27,173
25902406772,Arizona Cardinals coach Bruce Arians and The Pittsburgh Steelers coach Mike Tomlin still have some beef.,2016-06-21 12:44:36,link,63,60,36,159
10513336322,"""Are we prepared to tell lies, to spread hate and xenophobia just to win a campaign?""",2016-06-20 01:00:59,link,179,1,18,198
112638779551,This is the cutest thing you'll see all day.,2016-06-22 08:37:17,link,165,50,48,263
95926963131,Sheila Wysocki's best friend was brutally murdered and raped in 1984 and her case had gone unsolved for more than two decades. (via People True Crime),2016-06-22 11:02:07,link,26,86,39,151
13652355666,"Meet Boo and Lion, the newest male cheetah cubs on the block at Symbio Wildlife Park.",2016-06-20 17:50:00,video,70,99,28,197
112638779551,LeBron James dishes out compliments at today's victory rally!,2016-06-22 18:48:39,video,21,80,5,106
7245371700,Should regular citizens worry that their rights are being violated?,2016-06-24 08:40:48,link,53,78,38,169
5281959998,"""The Chinese are getting good at building these computers, and it's a competitive issue now for U.S. industry and national security.""",2016-06-22 23:55:00,link,166,53,15,234
112638779551,LeBron James had some touching words for Craig Sager after working his first NBA Finals game ever.,2016-06-17 08:29:38,link,75,38,3,116
25902406772,Philly just got a boatload of talent with the No. 1 overall pick.,2016-06-23 18:38:06,video,33,16,10,59
25902406772,"Yeah, that was pretty bad.",2016-06-18 19:19:29,link,81,62,40,183
10606591490,"""How 'The Apprentice' shaped Donald J. Trump's presidential campaign."" http://ti.me/28NEVFo",2016-06-21 12:15:54,video,116,100,41,257
7245371700,Almost all of my favorite Disney + Nickelodeon stars have been on Broadway.,2016-06-20 02:14:30,link,104,55,36,195
7245371700,Frank Ocean's emotional message about Orlando,2016-06-22 01:21:51,link,146,57,38,241
112638779551,Comerica Park could not contain this moonshot from Miguel Cabrera.,2016-06-21 08:09:13,link,162,78,22,262
112638779551,Who wins between Rory MacDonald and Stephen Wonderboy Thompson? Take a look at our picks and predictions for the UFC card this Saturday night.,2016-06-17 10:45:21,link,24,42,20,86
10606591490,3. Sell a product on Amazon.,2016-06-18 17:14:07,link,34,70,46,150
95926963131,Jennifer Carpenter is off the market!,2016-06-17 12:30:25,link,93,93,38,224
7245371700,Almost all of my favorite Disney + Nickelodeon stars have been on Broadway.,2016-06-15 06:39:34,link,140,35,7,182
112638779551,The unanimous MVP hints that he's been saving his best performance for the last game of the year.,2016-06-18 16:43:56,link,152,79,25,256
25902406772,Tiger Woods is being patient with his recovery.,2016-06-22 10:14:19,link,85,46,28,159
112638779551,"Sidney Crosby and the Pittsburgh Penguins showed up at the U.S. Open Championship today with some special hardware. #USOpen 

Welcome to Oakmont, Lord Stanley's Cup!",2016-06-16 17:29:25,video,84,83,9,176
75932763901,UGH SERIOUSLY??! See which famous mom was supposedly showing off her new purse....while she was naked! –> http://bit.ly/1Yu9BxV,2016-06-16 22:00:00,photo,45,89,46,180
25902406772,Jeff Teague will be heading to the Indiana Pacers.,2016-06-22 13:54:56,link,41,42,25,108
112638779551,New York Giants icon Lawrence Taylor made light of his iconic hit on former Washington Redskins quarterback Joe Theismann.,2016-06-16 20:19:24,link,55,26,11,92
75932763901,IT'S ON! Calvin Harris just exposed a BIG secret about Taylor Swift — and what he revealed could send her new boyfriend running for the hills: http://bit.ly/28RYWGZ,2016-06-24 16:30:00,photo,59,66,34,159
95926963131,Amber Rose has some thoughts on Taylor Swift and Tom Hiddleston that you're going to want to hear!,2016-06-20 22:04:08,video,147,99,34,280
86680728811,"Remington Arms, parent company of the manufacturer of the assault rifle used by Adam Lanza in the Newtown elementary school shooting, asks judge to strike lawsuit by families of the Sandy Hook victims.",2016-06-20 14:15:25,link,10,48,50,108
25902406772,Wayne Rooney is legendary for this.,2016-06-16 11:01:21,link,1,92,45,138
95926963131,Blake Lively and Ryan Reynolds were on a double date—but not with each other!,2016-06-23 15:44:04,link,115,30,4,149
75932763901,Is she glowing or what?!,2016-06-15 16:00:00,link,73,76,46,195
25902406772,The LA Lakers may have just drafted their next superstar.,2016-06-23 18:45:58,video,174,94,47,315
13652355666,He is facing federal charges.,2016-06-21 23:50:00,link,47,5,16,68
52150999700,The Late Show with Stephen Colbert shocked the audience while seriously slamming Donald J. Trump. 😯,2016-06-15 08:16:04,link,107,85,10,202
10606591490,"Blake Lively: ""It's nice to have a nice curve and not look like you're starving to death.""",2016-06-22 09:00:07,link,3,12,21,36
95926963131,"Bethenny Frankel may live much of her life in the public eye, but this time she's trying to keep her new relationship private.",2016-06-22 08:50:05,link,52,90,18,160
75932763901,Calvin Harris claims he didn't cheat on Taylor Swift before the breakup — but THIS naked pic that just leaked tells a different story! –> http://bit.ly/1XZE6wS,2016-06-18 07:15:00,photo,106,12,29,147
75932763901,"""I took my weight off the old-fashioned way. I like to call it the Just Keep Your F---ing Mouth Shut and Eat Air diet."" See which famous mama admitted to starving herself to lose her baby weight —> http://bit.ly/28SVX6D",2016-06-23 13:30:00,photo,2,71,50,123
7245371700,"""If you're following the line of Mitski Miyawaki's career, you're tracing the unmistakable arc of a rock star.""",2016-06-18 10:58:48,link,154,54,20,228
95926963131,"In honor of National Wedding Day, read some of the craziest stories from the front lines of the industry.",2016-06-21 14:09:10,link,112,27,36,175
18807449704,NOPE,2016-06-16 04:23:19,link,50,78,21,149
25902406772,Ben Simmons knows what's expected of him.,2016-06-23 18:50:56,video,90,56,16,162
112638779551,Another prominent QB is looking to turn the tide away from extra point attempts.,2016-06-15 13:48:57,link,39,78,50,167
112638779551,Alexander Gustafsson returns to the UFC in September where he faces Jan Blachowicz in Germany.,2016-06-17 02:58:28,link,147,31,14,192
25902406772,"If LeBron James wants to do some more trolling at the parade, this might work.",2016-06-22 07:45:13,photo,87,81,45,213
25902406772,D'Angelo Russell stole the show.,2016-06-21 10:57:32,link,131,71,25,227
25902406772,The Florida Panthers just made a sizable investment.,2016-06-23 00:36:59,link,74,93,34,201
86680728811,Dads across the country were glued to their seats watching the final moments of Game 7 between the Cleveland Cavaliers and Golden State Warriors on Father's Day -- including the Commander-in-chief himself.,2016-06-20 05:32:03,link,39,42,29,110
86680728811,Nighttime view of wildfires burning near Los Angeles that have forced residents from their suburban homes as intense heatwave scorches the southwest: http://abcn.ws/28JUBFC,2016-06-21 00:38:56,video,12,24,48,84
25902406772,This is possibly one of the best worst pranks ever.,2016-06-16 10:33:22,link,97,18,25,140
18807449704,Winning the NBA Finals wasn't enough for LeBron James.,2016-06-20 16:32:54,link,115,85,30,230
10606591490,"""To this day I can't even relate to that level of confidence.""",2016-06-21 13:30:27,link,29,57,2,88
52150999700,Ben and Lauren have made The Bachelor history by becoming the first couple to launch their own spin-off show. 💕,2016-06-23 21:39:00,link,11,49,37,97
25902406772,The Chicago Cubs love their old man.,2016-06-19 11:04:33,link,112,2,36,150
112638779551,"Von Miller announced on Instagram that there's ""no chance"" he plays this season under the franchise tag.",2016-06-16 11:35:49,link,82,29,48,159
112638779551,Los Angeles Angels fans made history Tuesday. Umbrella history.,2016-06-15 08:38:24,link,61,28,5,94
13652355666,Omar Mateen's school records show he was a disruptive student who struggled with English.,2016-06-16 09:54:00,link,160,11,20,191
112638779551,It didn't take long after Game 7 for one member of the 1995-96 Chicago Bulls to remind the Golden State Warriors that they came up short.,2016-06-20 00:22:39,link,112,79,48,239
112638779551,"The last time Cleveland won a major sports team championship, Gary Collins of the Cleveland Browns was the hero of the NFL title game in 1964.",2016-06-19 11:44:58,link,140,74,50,264
112638779551,It's been causing fits at the U.S. Open Championship all day. Take a virtual look inside the 3rd at Oakmont. #USOpen,2016-06-19 11:56:39,video,7,50,14,71
112638779551,"The WWE championship changed hands, not once but twice at the Money in the Bank Pay-Per-View. At the end of the show, Dean Ambrose dethroned Seth Rollins, who had just taken the title from Roman Reigns.",2016-06-20 05:03:28,link,39,84,3,126
7245371700,So many parties and not a single invite.,2016-06-19 21:34:07,link,30,100,29,159
5281959998,"While you're watching Russia on the field during UEFA EURO, see in real time its chances of advancing to the next round.",2016-06-20 01:05:00,link,194,60,25,279
86680728811,"Former Speaker of the House Dennis Hastert reports to prison in wheelchair to serve his 15-month sentence for financial crimes related to decades-old, repeated sexual abuse of minors.",2016-06-22 12:52:42,link,137,63,5,205
112638779551,The all-out push for Kevin Durant is a little more than a week away and his former Oklahoma City Thunder teammate James Harden will go all out to get him to join the Houston Rockets.,2016-06-23 16:58:51,link,138,16,30,184
13652355666,Pop culture dads have evolved since the days of Ward Cleaver and Andy Griffith: http://usat.ly/24VHKXg,2016-06-19 12:22:00,photo,155,49,28,232
5281959998,Breaking News: Donald J. Trump faces the worst financial disadvantage in recent presidential history: $1.3 million on hand to Hillary Clinton's $42 million.,2016-06-20 21:55:45,link,89,6,3,98
25902406772,"The USMNT has been here before, but can they do it again?",2016-06-18 21:02:00,link,58,71,29,158
10513336322,"Twiggy: ""I have always been a blonde – out of a bottle.""",2016-06-18 05:00:01,link,48,68,22,138
95926963131,"Leona Lewis and Lisa Vanderpump are teaming up in creative way to bring an end to this sick, cruel tradition. (via PEOPLE Pets)",2016-06-21 04:00:16,link,163,97,8,268
112638779551,Greatness runs in these families:,2016-06-19 13:12:57,link,17,16,21,54
7245371700,Congrats to these two!!,2016-06-16 07:23:57,link,73,18,43,134
7245371700,Bet this Game of Thrones character didn't see this one coming.,2016-06-20 09:48:04,link,106,30,19,155
95926963131,Jimmy Kimmel Live is giving us more Baby The Bachelorette! 😂,2016-06-18 19:20:07,link,39,30,46,115
7245371700,These memes are ~Loki~ hilarious.,2016-06-21 00:49:35,link,176,93,26,295
112638779551,"The Cleveland Cavaliers are NBA champions....

And one of their key players has decided that he will go out on top, and retire...",2016-06-19 23:43:43,link,76,29,27,132
13652355666,"""Let me say to our LGBT friends and family ... This Department of Justice – and your country – stands with you in the light.""",2016-06-22 02:00:00,link,189,1,9,199
10606591490,"""I wanted to do something to keep gun violence in the forefront of not only the American people but, more specifically, members of Congress.""",2016-06-23 15:30:15,link,195,50,17,262
5281959998,Daily Briefing: Here's what you need to know today.,2016-06-23 05:30:00,link,174,54,10,238
52150999700,Game of Thrones season 6 finale will be its longest episode ever—and equally as epic. 😱,2016-06-20 12:57:00,link,45,82,5,132
5281959998,"One man has championed a 20-inch-by-24-inch Polaroid, so big and irredeemably analog that it feels, he says, ""as if we're pulling oil paintings out of the back of it.""",2016-06-20 23:55:00,link,122,94,43,259
86680728811,"Indiana teen arrested Tuesday researched potential terrorist targets in his home state before attempting to make his way to Libya to join ISIS, federal officials say.",2016-06-21 22:31:50,link,112,20,13,145
75932763901,"Just one month after confirming their split, Teen Mom 2 star Kailyn Lowry makes the announcement NO ONE saw coming — read it here: http://bit.ly/28JjAZZ",2016-06-21 09:00:01,photo,90,14,41,145
7245371700,"Music can't erase the pain of tragedies like Orlando, but it helps us keep the faith.",2016-06-21 01:26:08,link,1,100,13,114
18807449704,French police use tear gas to control riots at Euro 2016.,2016-06-15 21:50:00,video,183,13,34,230
13652355666,"Jackson was acquitted on 14 felony and misdemeanor charges. But for some, that wasn't the end of the matter.",2016-06-23 03:15:00,link,135,1,9,145
10606591490,"A former Nazi guard has been sentenced to five years in jail for his involvement in 170,000 deaths at Auschwitz. http://ti.me/1UE3ZeE",2016-06-17 12:46:49,video,10,92,31,133
25902406772,Things aren't looking good for the Chicago Blackhawks.,2016-06-15 14:50:22,link,113,50,49,212
52150999700,The Breaking Bad alum is making the ultimate 'Power' move. 💪🏼,2016-06-21 19:35:36,link,132,62,37,231
25902406772,That didn't go as planned is our guess.,2016-06-18 22:53:28,link,80,73,47,200
112638779551,Charlie Villanueva knows how to make his son's 8th birthday party special. PROcast,2016-06-17 19:56:23,video,55,8,44,107
112638779551,"LeBron James confirms he's coming back to the Cleveland Cavaliers.

Rest easy, Cavs fans.",2016-06-22 11:05:11,link,8,62,5,75
112638779551,Kevin Love shared the one LeBron James memory from the NBA Finals he'll tell people about when he's old.,2016-06-20 12:09:07,link,184,10,40,234
25902406772,Sometimes people do some strange things.,2016-06-22 10:24:03,link,132,26,36,194
95926963131,That's a lot of candles!,2016-06-21 01:00:46,link,87,9,35,131
75932763901,"SO SAD! Jon Gosselin made a troubling revelation about his ex-wife, Kate Gosselin — and we can't imagine how their children will react after hearing this: http://bit.ly/28QlnNW",2016-06-23 14:30:01,photo,167,53,41,261
18807449704,This family clearly sticks together.,2016-06-20 20:42:10,link,18,78,4,100
75932763901,PATERNITY BOMBSHELL! Get the shocking details —>  http://bit.ly/1toF1JV,2016-06-15 00:00:01,photo,54,62,32,148
25902406772,This one went a looooong way.,2016-06-20 21:02:18,link,194,81,39,314
75932763901,Céline Dion's twins Eddy and Nelson Angelil are getting SO big! Wait until you see them today (via Closer Weekly) —> http://bit.ly/1WuFxyH,2016-06-19 03:30:01,photo,20,54,32,106
13652355666,Libby Schwichtenberg's daily iced coffee habit ended up paying off in the biggest way. http://usat.ly/28P8tDW,2016-06-22 18:22:00,video,114,47,27,188
95926963131,Real Housewives of New York City star Bethenny Frankel reveals her fear behind her health crisis.,2016-06-22 08:06:05,link,132,67,25,224
10606591490,Blake Lively might be a bigger Harry Potter fan than you.,2016-06-21 11:30:35,link,126,85,34,245
112638779551,"Five months after Lawrence Phillips was found unresponsive in a jail cell, the official coroner's report is finally out.",2016-06-15 13:13:35,link,145,53,3,201
7245371700,"""I'm learning to love and accept who I am — inside and out.""",2016-06-20 21:43:24,link,70,2,19,91
86680728811,JUST IN: Russia's track and field athletes will remain barred from Rio Olympic Games in wake of doping scandal. http://abcn.ws/1XZspX2,2016-06-17 10:54:07,link,70,79,37,186
7245371700,"The OG, Ice Cube turned 47 this past week! Here's him at 20 talking about his newfound fame with us.",2016-06-19 19:35:03,link,25,81,5,111
5281959998,"After months of waiting, our reporter Declan Walsh finally got a government visa to visit Syria. Here's what he saw. 

Declan will be answering questions about his road trip through Syria, which he took in April. Please post them below.",2016-06-17 08:25:00,link,13,56,47,116
5281959998,"He removed his artificial legs and shuffled his way to the front of a courtroom, as his lawyers pleaded with a judge to sentence him to community service rather than prison.",2016-06-15 10:55:00,link,67,32,16,115
75932763901,CONGRATS!! Get the details on the Duggar family's newest addition —> http://bit.ly/28JxeMR,2016-06-20 20:30:00,photo,34,53,21,108
75932763901,"CONGRATULATIONS! Following two adoptions, this famous lady is PREGNANT —> http://bit.ly/28QMxnT",2016-06-23 17:30:00,photo,51,87,36,174
75932763901,"OMG! This star called the cops because she ""did not feel safe"" around her husband! Find out who (via Life & Style Weekly) —> http://bit.ly/24WsTvM",2016-06-18 01:30:00,photo,91,84,14,189
10606591490,"Madeleine K. Albright: ""The people Donald J. Trump is holding responsible share more in common with the victims of this attack than with the perpetrator.""",2016-06-20 11:30:05,link,157,85,2,244
13652355666,"There are about 10,000 U.S. troops in Afghanistan.",2016-06-23 23:30:00,link,164,57,15,236
25902406772,MVP's on and off the court. Happy Father's Day to all the dads out there.,2016-06-19 13:23:41,photo,74,94,6,174
10513336322,"A new service called spoiled.io has just been launched. For a fee, it will text anonymous Game of Thrones spoilers to your arch nemesis the moment it finishes airing in America.",2016-06-23 08:40:01,link,80,85,11,176
52150999700,The Hunchback of Notre Dame is an underrated Disney gem.,2016-06-21 21:23:00,link,52,7,46,105
10513336322,"""We are employed as 'independent contractors' but that's just ridiculous legal mumbo-jumbo, to allow the company to duck its responsibilities.""",2016-06-15 12:15:00,link,11,87,2,100
7245371700,Is he under arrest for having too good of an album?,2016-06-21 22:47:01,link,67,76,49,192
75932763901,RUDE! We can't believe Kim Kardashian West would be THIS selfish on daughter North West's birthday!! See the Instagram post that says A LOT about her personality 😒  –> http://bit.ly/1Yse5Fa,2016-06-15 16:30:00,photo,97,76,6,179
10513336322,"""Britons, vote in our name.""",2016-06-23 09:00:00,link,180,79,21,280
10606591490,"""But why did people expect Ayesha to apologize for her tweet, and not expect her husband to apologize for hurling his mouthguard?""",2016-06-17 16:00:46,link,32,18,3,53
13652355666,The big cat escaped its handlers shortly after the ceremony.,2016-06-22 05:48:48,link,56,44,38,138
5281959998,"More people are on the run than ever before in recorded history, the United Nations said.",2016-06-20 03:55:01,link,23,3,26,52
10513336322,"""Whatever we might think of the EU – whether we love it or loathe it – one thing is certain. If Britain pulls out and thus provokes or accelerates its disintegration, we will instantly achieve most-hated nation status, not just in Europe but far beyond. It could well turn into the worst example in history of cutting off your nose to spite your face.""",2016-06-20 02:20:00,link,167,69,18,254
25902406772,"Keith ""One Time"" Thurman vs. Showtime Shawn Porter is going to be L-I-T.

Showtime Boxing gets you up close and personal with the fighters.",2016-06-16 12:29:57,video,8,20,20,48
13652355666,Here's a funky idea for your next vacation.,2016-06-21 17:06:01,video,185,69,10,264
7245371700,Get your Daria fix on Hulu!,2016-06-23 10:32:31,link,163,23,21,207
112638779551,"Jake ""The Snake"" Roberts offers insight into his career and recovery. The WWE legend also dishes on Sting, Ricky Steamboat and Stone Cold Steve Austin.",2016-06-22 09:38:26,link,69,7,3,79
75932763901,Blac Chyna just made a serious change to her body while pregnant!!! (via Life & Style Weekly) —> http://bit.ly/1YzwBeu,2016-06-20 08:00:00,photo,195,3,22,220
112638779551,"A championship, a stopover in Las Vegas, Nevada and Matthew Dellavedova had the energy to hit a theme park Monday.",2016-06-21 11:11:39,link,88,54,28,170
86680728811,"""I am moved to tears yet again as I struggle to put our experience into words. In spite of a few hateful, broken human beings in this world who can all too easily legally get their hands on mass assault weapons - people ARE kind. People DO care,"" JetBlue Airways flight attendant Kelly Davis Karas said. http://abcn.ws/1UlO1IV",2016-06-16 16:58:23,link,199,31,33,263
112638779551,"Cleveland Cavaliers forward Channing Frye gets pretty intimate with the Larry O'Brien trophy. 

Kristen Balboni for @TheBuzzer",2016-06-20 17:28:29,video,31,47,22,100
75932763901,TWINS! This little cutie is a splitting image of her famous mommy! —> http://bit.ly/28SJqQV,2016-06-23 12:30:00,photo,116,44,36,196
7245371700,"Remembering Star Trek actor Anton Yelchin, who died this weekend at 27. Read more: http://on.mtv.com/28K7vbo",2016-06-20 12:47:03,video,152,11,32,195
112638779551,From Michael Jordan trade possibilities to the pharmacist who got drafted at age 49. #NBADraft,2016-06-22 14:26:54,link,18,27,40,85
52150999700,Steven Spielberg is the latest to share memories of working with the young actor.,2016-06-22 17:39:00,link,36,95,22,153
95926963131,The judge has faced intense backlash since the Brock Turner sentencing.,2016-06-15 11:46:06,link,75,86,47,208
86680728811,These are the names and faces of the Orlando shooting victims. http://abcn.ws/1XobBrY,2016-06-15 09:13:07,video,174,94,15,283
52150999700,Sometimes we all just need to watch Dwayne The Rock Johnson and Kevin Hart for a good laugh!,2016-06-19 11:40:00,link,48,16,50,114
95926963131,Audrey Hepburn's mother was not Mel Ferrer's biggest fan—and that's putting it lightly.,2016-06-15 05:00:08,link,28,47,13,88
86680728811,"""Downtown Orlando has no bottom,"" Assistant State Attorney Kenneth Lewis wrote on his Facebook page last Sunday evening—less than 24 hours after the massacre at Pulse nightclub. http://abcn.ws/21sImCO",2016-06-18 17:59:09,link,155,34,22,211
10513336322,"Will Italy shackle Zlatan Ibrahimovic and repeat their impressive opening performance?

Follow all the action from Italy v Sweden in UEFA Euro 2016 – live!",2016-06-17 07:40:00,link,76,28,24,128
112638779551,"Even after the NFL Draft exodus, here's why Ohio State University Football is still the Big Ten's best team.

Plus more on a new episode of The Audible.",2016-06-16 16:24:28,link,107,46,11,164
112638779551,LeBron James apparently took the NBA Championship Trophy home with him after Wednesday's parade and rally.,2016-06-23 17:33:47,link,14,31,25,70
86680728811,"Pres. Barack Obama blasts the Senate for blocking 4 votes on gun control measures, considered in the wake of the Orlando shooting in which 49 people were killed.",2016-06-21 12:01:32,link,184,99,37,320
18807449704,Senator ends gun control filibuster with heart-wrenching story about Sandy Hook.,2016-06-16 15:00:00,video,109,81,44,234
112638779551,Pittsburgh running back James Conner chatted with Craig Sager before tip-off.,2016-06-17 10:09:05,link,47,30,35,112
95926963131,The family had reportedly been living on the 29-foot sailboat they were last seen in off of Florida's Gulf Coast.,2016-06-23 09:52:05,link,175,41,29,245
13652355666,"They were attending a vigil for someone who drowned in Salinas, Calif.",2016-06-15 07:34:58,link,87,66,20,173
7245371700,Where exactly do Hillary Clinton + Donald J. Trump stand on guns + gun reform?,2016-06-16 15:45:49,video,45,78,34,157
10513336322,"""It's all about making little decisions, choices, changes and hopefully improvements each day, including diet, that are right for that day.""",2016-06-19 14:30:00,link,140,19,24,183
10606591490,Which smartphone is right for you?,2016-06-20 20:01:13,link,81,33,36,150
95926963131,The frightening attack came as Wallace and his family were leaving a Rascal Flatts concert.,2016-06-22 19:51:05,link,126,35,3,164
7245371700,Is Arya headed to Winterfell or what??,2016-06-19 18:48:04,link,163,92,43,298
10606591490,How the world celebrated the International Day of Yoga. http://ti.me/28OQkF2,2016-06-21 23:30:41,video,103,3,41,147
13652355666,"The Supreme Court might decide today if it will hear a gun rights group's challenge to Connecticut's assault weapons ban, which was passed days after the Newtown massacre of 2012. (Photo: Rich Pedroncelli, AP)

More things to know: http://usat.ly/1WOz9q3",2016-06-16 06:06:01,photo,43,86,47,176
112638779551,The Cleveland Cavaliers apparently were pushing for a harsher punishment for Golden State Warriors forward Draymond Green.,2016-06-16 19:18:49,link,39,83,7,129
10513336322,It's in the bag.,2016-06-22 05:40:01,link,186,2,39,227
13652355666,"""It shouldn't take things like Flint to get the nation's attention.""",2016-06-20 03:40:00,link,132,76,46,254
25902406772,Daniel Sturridge's late winner sends this bar in a FRENZY.,2016-06-16 13:51:07,link,176,83,14,273
18807449704,"When familiar icons are given a facelift, people take notice.",2016-06-20 23:20:00,link,10,59,5,74
5281959998,Both Democrats and Republicans have put forward gun safety measures. None are expected to pass.,2016-06-20 05:55:01,link,164,31,33,228
10513336322,"""We wholly understand that everyone makes mistakes, but Zara, as an ambassador for Miss Great Britain, simply did not uphold the responsibility expected of the title.""",2016-06-17 11:00:00,link,72,16,4,92
25902406772,The Dallas Mavericks have some key players on their radar.,2016-06-23 16:41:22,link,31,81,49,161
25902406772,Tiger Woods wasn't always cool and calm.,2016-06-23 14:06:03,link,168,52,6,226
10606591490,4 cues give it away.,2016-06-17 02:30:20,link,14,72,36,122
112638779551,Conor McGregor is pulling out all the stops to make sure he doesn't lose to Nate Diaz for a second time at UFC 202.,2016-06-17 11:26:44,link,28,24,15,67
25902406772,Adrian Peterson says the annual offseason grind might play into his decision one day.,2016-06-22 19:20:37,link,126,41,1,168
86680728811,"A neighbor said she had long felt that ""something isn't right"" at a Bucks County home where a man is accused of sexually assaulting a teenager whose parents police say gave her to him when she was 14.",2016-06-20 06:05:32,link,179,23,37,239
112638779551,Jeff Van Gundy is not a fan of how the NBA handled Draymond Green.,2016-06-16 11:20:12,link,40,65,17,122
5281959998,LGBT people are the most likely targets of hate crimes in America.,2016-06-16 05:00:59,link,158,86,35,279
95926963131,Meet the couple who took a heartbreaking loss and turned it into a passion project.,2016-06-23 16:28:02,link,37,46,37,120
86680728811,"""His mouthpiece hit me in the face and he was actually very polite,"" the fan said. Stephen Curry was ejected from the game over the incident. http://abcn.ws/1UTkvdx",2016-06-17 19:36:50,link,45,33,9,87
52150999700,A Breaking Bad alum is heading back to the small screen with Jennifer Lopez!,2016-06-15 12:08:47,link,3,68,15,86
86680728811,Some frozen peas and mixed vegetables are being voluntarily recalled over fears they could be contaminated with listeria.,2016-06-21 14:10:27,link,40,93,7,140
112638779551,Jordan Spieth is wearing Stephen Curry's shoes at the U.S. Open and people are already roasting him,2016-06-19 09:50:53,link,196,51,34,281
7245371700,My eyes have definitely opened up more to who Justin Bieber is as a person.,2016-06-19 08:54:53,link,53,94,19,166
112638779551,The 1st U.S. Open Championship looked A LOT different than it does today. #Betcha,2016-06-17 13:06:54,video,125,10,35,170
25902406772,Ewwwwwwwwwww,2016-06-15 16:01:58,link,75,41,11,127
52150999700,Disney Pixar was not impressed. 😂,2016-06-15 22:47:00,link,9,36,22,67
95926963131,Selena Gomez's long-awaited carpool karaoke segment with James Corden did not disappoint!,2016-06-21 08:35:08,link,121,48,49,218
86680728811,"The accused killer of British lawmaker Jo Cox gave his name as ""Death to traitors, freedom for Britain"" in his first court appearance.",2016-06-18 06:33:52,link,8,66,4,78
25902406772,Stephen Curry has no excuses for coming up short.,2016-06-20 09:34:25,link,103,41,19,163
5281959998,"""This was terrific."" — Carol Sacks, a reader.",2016-06-18 22:25:00,link,60,96,12,168
13652355666,"He ""could use the rest.""",2016-06-24 00:30:00,link,85,36,36,157
7245371700,And Chris Brown responded in a video he posted to Instagram.,2016-06-23 22:55:19,link,41,8,7,56
25902406772,JR Smith's championship presser will give you ALL of the feels.,2016-06-20 00:21:23,link,148,33,40,221
95926963131,Radiohead is sending their love after fans in Istanbul were attacked.,2016-06-17 20:56:04,link,138,65,46,249
52150999700,These UnREAL stars have come a LONG way.,2016-06-21 03:12:00,link,129,3,35,167
10513336322,"""No newspaper in this country's history has more consistently, and at times more rabidly, pursued political objectives than the Daily Mail – from war with Germany in the early 20th century, to the promotion of Hitler, Mussolini and British fascism in the interwar period, to the drive to get Britain out of the EU in our own lifetimes – along with the defeat of Labour at all times, by fair means or foul.""",2016-06-17 02:40:00,link,147,35,18,200
86680728811,"Donald Trump has warmed to potentially changing gun laws to ensure that no one with even ""an inclination toward terrorism"" can legally purchase guns. He's also been reiterating that the Orlando nightclub massacre might not have ended so tragically had clubgoers been armed.",2016-06-18 23:26:44,link,175,81,28,284
10513336322,"""Technology has made us able to do more while understanding less about what we are doing, and has increased our dependence on others.""",2016-06-23 09:40:01,link,77,41,20,138
5281959998,Why do younger men feel more comfortable talking about growing old?,2016-06-23 03:55:00,link,51,31,29,111
7245371700,"""My hermanos and hermanas went to Pulse with the knowledge and comfort that they would be understood there, that they would be en casa.""",2016-06-18 08:51:29,link,33,1,19,53
25902406772,The U.S. Open Championship is coming down to the wire.,2016-06-19 08:31:04,link,72,38,6,116
10606591490,Kendall Jenner as you've never seen her before.,2016-06-22 18:00:25,link,29,51,27,107
10606591490,It can even throw out the trash.,2016-06-24 04:30:09,link,64,7,26,97
5281959998,We're live at Art Basel with New York Times culture reporter Robin Pogrebin.,2016-06-15 10:30:19,video,110,87,34,231
112638779551,Shaquille O' Neal names James Harden the biggest fool in the NBA.,2016-06-15 09:37:28,link,43,1,44,88
13652355666,BREAKING: Jo Cox has died.,2016-06-16 11:42:22,link,99,93,29,221
5281959998,"The 5-year-old was playing outside with his older brother when his mother, who was inside the house, heard screaming. She ran outside and saw a mountain lion on top of her son.",2016-06-19 09:55:00,link,67,19,10,96
13652355666,Could this become a painful reminder or a home for activism?,2016-06-15 05:27:58,link,159,25,16,200
13652355666,BREAKING: The discovery of the EgyptAir black box comes days before the 30-day lifespan expires on the batteries.,2016-06-16 08:37:33,link,122,94,16,232
10513336322,"""Would Jeremy Hunt be comfortable with his own parents or his own children being treated at this hospital?""",2016-06-15 02:40:00,link,106,22,43,171
13652355666,"The 2016 summer solstice occurs Monday, which means spring is over and we'll be getting more daylight than on any other day of the year. 

More news you need to know: http://usat.ly/28IoE1E

(Photo: Matt Cardy, Getty Images)",2016-06-20 06:00:00,photo,161,97,33,291
10606591490,This is Amazon's secret weapon.,2016-06-17 21:30:31,link,15,26,47,88
18807449704,This Game of Thrones melon carving might be the scariest thing ever.,2016-06-23 18:24:38,video,71,100,25,196
86680728811,"Woman defends homeless man's shopping cart when he collapses on the street, then pays for ticket to New York so he can be with loved ones. ""I cannot even put into words how much happiness this has brought to me knowing that I am bringing happiness to him.""",2016-06-16 21:58:49,link,172,78,48,298
112638779551,"The 1986 NBA Draft produced many sad stories. The trades the Philadelphia 76ers made around that selection day turned out poorly, to say the least.",2016-06-22 11:53:16,link,103,31,34,168
86680728811,"Relishing role as attack dog, Elizabeth Warren calls Trump a ""small, insecure money grubber"" and ""thin-skinned racist bully."" http://abcn.ws/1Y1fXGl",2016-06-18 13:50:52,link,169,35,27,231
7245371700,He also had some very beautiful things to say about his late baby sister.,2016-06-18 06:51:02,link,37,91,26,154
95926963131,The Kardashians don't skimp on birthday parties! (via People Babies),2016-06-19 13:20:09,link,178,62,17,257
25902406772,Kris Dunn leads this edition of the Big Board.,2016-06-17 16:26:48,link,26,28,46,100
10513336322,Keep on truckin'?,2016-06-17 09:40:00,link,124,37,16,177
5281959998,"If your arguments often escalate to hollering, you might consider a checkup with a cardiologist.",2016-06-23 06:55:01,link,161,98,27,286
18807449704,"65,724 sandwiches!",2016-06-18 05:00:00,link,156,67,17,240
13652355666,"Baylor University used Art Briles as ""camouflage to disguise and distract from its own institutional failure"" in handling sexual assaults committed by athletes, the fired football coach's lawyer states.",2016-06-16 15:15:00,link,174,15,38,227
18807449704,Here's what the knock off iPhone market is looking like.,2016-06-17 18:59:17,link,111,77,30,218
86680728811,"A brush fire that broke out Sunday near downtown Los Angeles threatened a densely populated, hilly neighborhood along a freeway as sizzling temperatures elevated fire danger across the West.",2016-06-20 01:42:00,link,78,30,47,155
25902406772,"Jordan Spieth isn't on top of the leaderboard, but he's not out of it yet.",2016-06-17 10:13:18,link,120,69,45,234
13652355666,May Ashworth thought there was someone at Google HQ answering her queries.,2016-06-17 13:57:00,link,16,37,33,86
112638779551,"WWE's Nikki Bella is hoping to make a comeback soon, and she's training with brother-in-law Daniel Bryan",2016-06-17 15:46:39,link,197,94,3,294
112638779551,Nico Rosberg returns to the top step of the #F1 podium.,2016-06-19 09:42:20,link,84,55,2,141
112638779551,Stephen Curry gets ejected in 4th quarter of Warriors loss to Cavaliers. Game 7 is Sunday:,2016-06-16 22:56:56,link,92,41,18,151
18807449704,"Attention, Game of Thrones:
15. Ghost shows up and mauls Ramsey.",2016-06-17 11:01:49,link,98,8,48,154
52150999700,This isn't good news for At The Drive In fans. 😓,2016-06-18 19:31:00,link,68,19,12,99
75932763901,OMG! Get the exciting details on Ivanka Trump's Baby No. 4 news (via Closer Weekly) —> http://bit.ly/1ZRnWTv,2016-06-15 14:30:00,photo,51,43,23,117
13652355666,Heartbreaking.,2016-06-16 21:30:00,link,106,9,43,158
112638779551,Bring on Game 7!,2016-06-16 22:47:21,link,183,51,38,272
10606591490,"""I'm part of you now.""",2016-06-20 14:00:51,link,63,1,12,76
5281959998,"Dozens of Democrats plunked down on the floor of the House, effectively halting any legislative activity as they chanted, ""No bill, no break!""",2016-06-22 12:30:13,link,52,60,41,153
75932763901,NO WAY! We bet you didn't know these two stars once shared an apartment before they were famous (via Closer Weekly) —> http://bit.ly/1sAaVTw,2016-06-23 06:45:00,photo,125,87,17,229
5281959998,Corey Lewandowski is joining CNN as a political commentator.,2016-06-23 18:14:00,link,173,71,34,278
95926963131,The oldest of the girls was allegedly the mother of the 6-month-old and a 3-year-old. (via People True Crime),2016-06-23 17:15:57,link,116,67,24,207
25902406772,The Olympic squad is starting to shape up.,2016-06-23 10:47:37,link,196,19,23,238
10606591490,"""It appears she had some knowledge of what was going on.""",2016-06-15 08:00:54,link,41,37,23,101
75932763901,Dwayne Johnson made a devastating confession about his past – and fans never saw it coming –> http://bit.ly/24M0NTJ,2016-06-18 17:45:00,photo,6,44,41,91
75932763901,"MOVE OVER, Kim Kardashian West! This sexy star is giving Kim's booty a run for its money —> http://bit.ly/28Oaehn",2016-06-24 03:30:00,photo,96,86,31,213
52150999700,"Watch out, world! Chewbacca Mom is getting her own action figure from Hasbro Gaming: http://share.ew.com/lPw8jKl 😂",2016-06-20 13:58:00,video,92,33,43,168
10513336322,Which brand of tea do you get out of bed for in the morning?,2016-06-15 09:20:00,link,164,83,1,248
7245371700,Keke Palmer dropped knowledge on the haters.,2016-06-21 04:22:48,link,111,84,19,214
52150999700,"Pretty Little Liars isn't exactly over, but the show is in for seriously game-changing answers. 😱🅰",2016-06-17 16:22:00,link,55,14,39,108
25902406772,Here's how to tune in to the UEFA EURO 2016.,2016-06-20 14:25:14,link,20,53,13,86
7245371700,"Whoa, that's a lot of dough.",2016-06-21 02:37:54,link,147,17,35,199
75932763901,"""I would not want [Kim's butt] — it's gross! It reminds me of cottage cheese inside a big trash bag."" YIKES! We can't believe she DISSED Kim Kardashian West like that! –> http://bit.ly/1MLogS9",2016-06-19 04:00:00,photo,145,58,44,247
112638779551,"Rougned Odor did admit that ""perhaps"" he and Jose Bautista were both wrong for their fight.",2016-06-16 13:54:45,link,187,4,4,195
13652355666,"The father struggled with the alligator to try to save his son, but was ""unsuccessful."" http://usat.ly/1UU1CV2",2016-06-15 06:42:00,video,197,31,43,271
18807449704,Seriously?!,2016-06-22 22:35:00,link,141,55,22,218
112638779551,"Looking for a scapegoat, Golden State Warriors fans? May we suggest your mercurial forward, who has picked a bad time to miss a lot of wide-open shots.",2016-06-17 07:10:00,link,57,66,44,167
95926963131,Who's your favorite TV Dad? Jess Cagle wants to know what you think! Happy Father's Day weekend!,2016-06-17 10:58:47,video,185,18,25,228
75932763901,Congrats! Find out how far along she is!!,2016-06-17 00:30:00,link,81,81,49,211
25902406772,Steve Kerr believes in his Golden State Warriors.,2016-06-16 21:58:32,link,32,35,35,102
112638779551,It looks like the Dallas Mavericks have a new No. 1 priority this offseason -- re-signing Dirk Nowitzki.,2016-06-21 21:09:48,link,93,69,5,167
25902406772,Can Elvis Dumervil and Terrell Suggs return to the top of the sacks leaderboard?,2016-06-22 09:27:06,link,105,97,43,245
25902406772,That is one ANGRY coach!,2016-06-15 17:47:28,link,48,48,30,126
13652355666,BREAKING: New Federal Aviation Administration drone rules will limit small commercial drone operations to daylight hours.,2016-06-21 09:55:45,link,31,38,4,73
10513336322,"""ABC's version of The Thick of It was an omnishambles, with no swearing because it was a network show.""",2016-06-23 05:20:00,link,62,64,42,168
25902406772,Joe Flacco addresses the rumors.,2016-06-23 16:36:39,link,45,19,11,75
5281959998,"Walter Mosley remembers his father: ""He was and is my inspiration, the man who taught me to bob and weave in life and art.""

Read on in The New York Times Books.",2016-06-19 19:55:00,link,126,83,33,242
10513336322,"Facebook has just launched support for 360-degree images and, even though they're not uplifting or inspiring, we're proud to bring you these exclusive pictures showing dead coral in the Great Barrier Reef Marine Park, from our special report, Reef on the Brink: http://www.theguardian.com/australia-news/series/reef-on-the-brink?CMP=fb_gu

Tilt your phone or drag your mouse to look around the devastation near Lizard Island.",2016-06-15 00:40:00,photo,72,69,44,185
5281959998,The massacre in Orlando came at the hands of a coward and a monster. Read on in The New York Times Opinion Section.,2016-06-16 06:55:00,link,167,83,40,290
95926963131,Officials found the 58-year-old man lying on the ground five feet from the alligator.,2016-06-22 13:37:04,link,164,46,16,226
5281959998,"One of the foremost experts on polling in Britain estimated voter turnout for the E.U. referendum at 72%. 

Follow our live blog for the latest results and updates.",2016-06-23 21:55:00,link,74,62,14,150
5281959998,"The straight economics is clear: A British exit from the E.U. would make Britain poorer, Paul Krugman writes in The New York Times Opinion Section.",2016-06-18 01:55:00,link,74,44,39,157
10513336322,Here is a string of smartphone apps that could make the task of staying in the black that little bit easier.,2016-06-19 01:40:00,link,34,3,16,53
112638779551,Brock Lesnar returns at UFC 200 but in the latest promo for the event he's still being touted as a WWE star.,2016-06-20 19:41:56,link,70,49,22,141
112638779551,"A years ago, we told you about the incredible story of how the great Rory McIlroy nearly played college golf at a tiny school, you've likely never heard of. 

With the U.S. Open Championship beginning today... we decided to share that story, once again...

It's one of the great chapters of Rory's life, few -- if any -- know about...",2016-06-16 07:31:14,link,16,48,18,82
86680728811,"Health officials followed 550 pregnant Colombians who 'reportedly contracted' Zika during the 3rd trimester of pregnancy. None of their babies were born with underdeveloped heads or brains, study shows.",2016-06-16 02:33:04,link,184,45,21,250
10606591490,Inspiring.,2016-06-23 01:30:08,link,146,18,22,186
75932763901,"Just weeks after calling it quits with Wilmer Valderrama, Demi Lovato went OFF on social media — and you'll be shocked when you see what she said —> http://bit.ly/28SOnEN",2016-06-24 13:30:00,photo,80,50,9,139
95926963131,Part of what makes the current season of The Bachelorette  so magical is the cast of men.,2016-06-21 17:31:10,link,12,85,23,120
10606591490,Tyra Banks had some things to say about whether Kendall Jenner and Gigi Hadid are supermodels.,2016-06-23 16:00:43,link,118,70,37,225
52150999700,Harry Potter himself has a very thoughtful reason for not attending the new stage play.,2016-06-15 08:59:00,link,133,14,34,181
52150999700,Oprah Winfrey's new series brings more people of color in more unique roles to TV.,2016-06-21 05:51:00,link,35,84,28,147
75932763901,Kelly Ripa shared a beautiful vintage photo of her mother to celebrate her birthday — You won't BELIEVE how much they look alike! --> http://bit.ly/28SPWqD,2016-06-23 15:00:00,photo,74,70,8,152
95926963131,Miss USA has the diet of our dreams! (via People Great Ideas),2016-06-17 08:06:08,link,23,68,5,96
10606591490,Watch this dad discover the wonders of virtual reality.,2016-06-19 19:01:02,video,83,72,6,161
112638779551,Ben Affleck went on an expletive-filled tirade to defend Tom Brady's honor.,2016-06-23 10:27:21,link,56,65,23,144
7245371700,"Here's what you 'Need to Know' on 6/17 from Kim Kardashian West, Lil Wayne, and Taylor Swift.",2016-06-17 05:07:30,video,47,81,30,158
112638779551,Each one carries the name of a local hero. Pittsburgh native Jim Kelly introduces you to the 'Three Sisters',2016-06-15 18:35:31,video,31,56,11,98
25902406772,"We don't know who's going to get José Reyes, but we have a pretty good idea who isn't.",2016-06-15 16:34:14,link,10,63,25,98
86680728811,"Canadian man successfully delivers healthy baby deer after its mother is hit by a truck. ""To her we are her parents.""",2016-06-16 21:33:33,link,32,24,27,83
5281959998,"Minutes after the polls closed in most of Britain, YouGov released results of its final poll on the E.U. referendum.",2016-06-23 17:27:41,link,198,46,35,279
112638779551,One of the most brutal injuries in NFL history did not discourage the Stingley family from pursuing their football dreams.,2016-06-17 19:43:04,link,70,76,49,195
25902406772,How bout these fresh uniforms?,2016-06-23 10:02:03,link,75,87,24,186
86680728811,"Experts say it's too soon to gauge whether a week of horrific news out of Orlando will hurt the city's tourism. But travel agents are not seeing widespread cancellations, and many travelers say they're committed to visiting. http://abcn.ws/1Qdj9M4",2016-06-18 14:24:46,link,121,49,24,194
112638779551,"In a game with tight margins, Steve Kerr's choice to stick with two ineffective players came back to haunt him, and the Golden State Warriors, writes Dieter Kurtenbach:",2016-06-20 02:10:46,link,95,18,36,149
13652355666,"The boy suffered injuries to his head, neck and face.",2016-06-18 03:55:00,link,168,84,16,268
25902406772,What's next for Kevin Love and the Cleveland Cavaliers?,2016-06-20 21:37:03,link,43,52,4,99
95926963131,You can always count us in for some skillet pizza pot pie! (via People Food),2016-06-22 12:53:00,video,149,59,34,242
52150999700,Take a tour of Disney's AWESOME new Frozen attraction: http://share.ew.com/lj2SGwZ ⛄️,2016-06-22 15:33:00,video,198,32,48,278
52150999700,YESS! A WICKED The Musical alum is joining the 'Hairspray Live!' cast! 👏🏼,2016-06-21 14:01:00,link,198,98,3,299
95926963131,"All three of the Kardashian sisters shared heartwarming messages for their late father, but didn't include a post for Caitlyn Jenner.",2016-06-20 12:08:06,link,14,55,15,84
18807449704,"""I didn't think so many people would be misinformed about it all and so complacent about it.""",2016-06-21 01:20:01,link,59,7,13,79
10513336322,"""I have seen the Queen sacrifice people and eat their flesh … When she shape-shifts she has a long reptile face.""",2016-06-16 11:40:00,link,18,53,30,101
52150999700,The Pretty Little Liars season premiere was FULL of drama. 😱,2016-06-21 22:59:58,link,4,66,39,109
18807449704,We have two words for you: Corgi Prom!,2016-06-15 12:30:38,video,79,83,29,191
10606591490,Fed-up Cristiano Ronaldo tosses a reporter's microphone into a lake. http://ti.me/28NUWfw,2016-06-22 20:15:37,video,183,82,29,294
112638779551,Dustin Johnson shows why he is still in U.S. Open Championship contention.,2016-06-18 17:35:24,link,177,54,47,278
5281959998,Daily Briefing: Here's what you need to know today.,2016-06-17 05:30:00,link,111,96,5,212
25902406772,LeBron James and the Cleveland Cavaliers know what they gotta do.,2016-06-16 22:51:12,video,26,31,48,105
7245371700,Grab your headphones and tissues now.,2016-06-20 12:31:46,link,27,59,44,130
7245371700,I can't listen to these without laughing.,2016-06-18 13:47:07,link,87,22,22,131
52150999700,The one and only Michelle Obama is hopping in the passenger seat for an EPIC ride with James Corden! 🎤,2016-06-21 12:57:33,link,96,73,33,202
5281959998,China is almost as wide as the continental U.S. And it all one time zone — Beijing time.,2016-06-16 15:25:00,link,156,51,16,223
52150999700,The Bachelor and The Bachelorette sure have a legacy of bad guys (and gals).,2016-06-22 02:19:00,link,82,59,49,190
10606591490,Inside the next big battle against ISIS. http://ti.me/28Ol7jc,2016-06-23 12:16:02,video,142,5,27,174
5281959998,"New York City passed legislation that will make menstrual products available where they're desperately needed, and the rest of the world should follow, Nicholas Kristof writes in The New York Times Opinion Section.",2016-06-22 14:25:00,link,158,13,32,203
13652355666,Mission: Bring smiles and hugs to the people of Orlando.,2016-06-16 09:17:00,video,45,62,24,131
10606591490,Brexit is already sending tremors around the world.,2016-06-24 07:30:16,link,36,12,27,75
95926963131,A 13-year-old girl's flight home takes a turn for the worst after this 26-year-old man sat next to her. (via People True Crime),2016-06-21 21:34:14,link,117,73,21,211
25902406772,Los Angeles Dodgers ace Clayton Kershaw is a monster.,2016-06-19 14:49:08,link,116,35,20,171
52150999700,Tom Hardy's latest role is coming into focus. 📷,2016-06-22 21:49:00,link,5,64,3,72
13652355666,"Democrats shouted ""Shame! Shame!"" as House business proceeded and members cast votes on a measure unrelated to guns.",2016-06-22 21:38:54,link,29,94,27,150
10513336322,"""What on earth possessed Microsoft to lay out $26bn for this turkey?""",2016-06-19 15:00:01,link,168,41,36,245
25902406772,Northern Ireland-Ukraine suffered a bit of a delay.,2016-06-16 13:09:12,link,193,5,39,237
5281959998,"Anderson Cooper was reading the names of the Orlando victims on CNN when, uncharacteristically, his voice wavered and he drew up short. For moments, viewers heard only silence, and then the sounds of the anchor struggling to compose himself.",2016-06-15 19:55:01,link,184,13,43,240
112638779551,Matt Marshall went from likely bogey to birdie thanks to a lucky break.,2016-06-17 13:30:33,link,189,49,47,285
18807449704,It's so hard being Blake Lively.,2016-06-23 19:01:23,link,75,31,30,136
86680728811,"From hunting to competition shooting to ""defending yourself from a tyrannical government,"" why AR-15 owners say they own the style of gun popular among mass shooters: http://abcn.ws/1Ys01et",2016-06-15 20:44:38,link,126,94,20,240
10606591490,Adorable.,2016-06-23 20:00:31,link,80,88,7,175
52150999700,Hamilton: An American Musical will continue their huge plans even after Lin-Manuel Miranda leaves the cast.,2016-06-17 12:16:00,link,45,68,23,136
25902406772,LeBron James fought through the pain to get the 1 the Cavs needed.,2016-06-19 22:33:06,link,185,12,1,198
7245371700,"All of these moments had you screaming, but only one can win at the Fandom Awards: http://on.mtv.com/28MPW6k",2016-06-22 12:30:00,photo,181,22,50,253
7245371700,My jaw basically hit the ground.,2016-06-21 09:30:52,link,186,9,44,239
52150999700,"Including Kevin Hart insulting James Corden for not being Ricky Gervais, and Corden slamming Hart for not being Chris Rock.",2016-06-16 07:10:00,link,165,90,47,302
18807449704,Wow,2016-06-17 05:30:00,link,117,35,39,191
112638779551,The New York Mets got a big scare when Big Sexy was hit on his thumb by a line drive Tuesday.,2016-06-22 08:13:20,link,54,42,42,138
7245371700,No one's immune to a mean Instagram comment.,2016-06-16 04:06:22,link,12,66,29,107
112638779551,Georges St-Pierre announces he's ready to return to fighting after 3 years away from the UFC,2016-06-20 16:19:05,link,145,32,48,225
75932763901,We bet you've never seen Tom Cruise like THIS before! Check out the new video that has all his fans buzzing (via Closer Weekly) —> http://bit.ly/28RD5U4,2016-06-23 07:15:00,photo,65,51,5,121
10513336322,"""Thus, as in Botticelli's 'Birth of Venus', our guest is framed and ready to step gracefully into the limelight and greet their audience … This is automotive haute couture.""",2016-06-17 03:20:01,link,162,4,24,190
86680728811,Slain singer Christina Grimmie's funeral is set for Friday near her hometown in New Jersey http://abcn.ws/1WNGki2,2016-06-15 12:20:00,link,143,55,42,240
95926963131,A Michigan Muslim group is encouraging its members to break tradition in order to help the Orlando community. 💛,2016-06-17 19:06:07,link,157,34,39,230
10513336322,"""The impacts of human-caused climate change are no longer subtle – they are playing out, in real time, before us.""",2016-06-18 01:40:00,link,44,8,23,75
112638779551,Former UFC title contender Chad Mendes breaks his silence after a failed drug test returned from USADA.,2016-06-20 12:47:54,link,191,22,24,237
5281959998,"Zim Ugochukwu, who founded Travel Noire, is sharing her best travel tips with The New York Times Styles.",2016-06-23 14:50:16,video,2,82,28,112
112638779551,The Golden State Warriors forward won't get much of a break this offseason.,2016-06-20 09:31:02,link,56,77,22,155
75932763901,Mariah Carey doesn't look like this anymore! See the weight loss transformation that has fans everywhere SPEECHLESS! (via Closer Weekly) —> http://bit.ly/1WWFLTE,2016-06-23 04:00:00,photo,94,17,29,140
86680728811,WATCH: President Obama growls at Yosemite National Park children's event to show kids how to scare away bears: http://abcn.ws/1QdxVm6,2016-06-18 18:40:19,video,126,94,3,223
7245371700,They seem pretty happy with their fashion choices.,2016-06-23 09:31:05,link,176,31,24,231
5281959998,"Britons will make a momentous choice on Thursday. Portraits of a nation contemplating a Brexit: http://nyti.ms/28OT5Sw

Photos: Adam Ferguson for The New York Times",2016-06-23 11:10:00,photo,173,13,9,195
5281959998,"This rodent is the first mammal made extinct by human-driven climate change, scientists say.",2016-06-15 07:28:00,link,133,38,45,216
112638779551,"With a chance at 4 HRs, Saunders came up with the bases loaded in the 8th ... and hit into a DP. Still a great night.",2016-06-17 21:32:42,link,123,79,9,211
5281959998,"Ninety percent of those killed in Orlando were Hispanic or of Hispanic descent, including 23 Puerto Ricans. ""It's as though it had happened in our own family,"" one woman said.",2016-06-15 06:25:01,link,90,76,4,170
75932763901,POOR AUBREE! Teen Mom 2 star Chelsea Houska's six-year-old daughter is going to be heartbroken after hearing her father did THIS —> http://bit.ly/28Ns59y,2016-06-22 22:01:00,photo,160,60,46,266
13652355666,"They call themselves ""single fathers by choice.""",2016-06-20 01:40:00,link,144,99,34,277
112638779551,Old man power.,2016-06-18 23:35:53,video,27,13,41,81
86680728811,"""I used to be jealous of all my friends who were close with their fathers growing up. For years, I watched and was invited to baseball games, dinners and even high school sporting events as my buddies all leaned on their dads for friendship and support. I never had that.""",2016-06-19 10:04:02,link,126,22,47,195
25902406772,Seattle Seahawks QB Russell Wilson is just living the dream.,2016-06-18 12:37:36,link,190,3,30,223
10606591490,Anton Yelchin's body was found crushed by his SUV.,2016-06-22 06:30:06,link,38,34,15,87
10606591490,Kim Kardashian West said she had an idea about Caitlyn Jenner early on.,2016-06-16 16:00:07,link,32,81,45,158
86680728811,Three top NYPD officials and a fundraiser for Mayor de Blasio have been arrested after being linked to the alleged exchange of lavish gifts for favors.,2016-06-20 19:30:39,link,134,2,6,142
86680728811,"Hillary Clinton says during campaign rally that she's ""gotten under"" Donald J. Trump's skin.",2016-06-22 20:01:32,link,29,20,41,90
75932763901,ADORABLE! Find out who just shared this sweet pic (via Closer Weekly) —> http://bit.ly/1Q8Gwqe,2016-06-17 00:00:00,photo,184,86,38,308
10606591490,Will Melisandre be punished?,2016-06-22 11:30:20,link,119,83,28,230
10513336322,"""There were places with infinity pools, private butlers, views on to the Pacific. But, then, in fairness, I do bake a nice scone for everyone who comes.""",2016-06-20 03:20:00,link,79,24,37,140
7245371700,Tfw Pretty Little Liars roots for team Emison (!!).,2016-06-22 11:01:44,link,200,95,21,316
7245371700,"""'Hero' has the ring of an album whose potential enlivening quirks were sanded down somewhere along the way.""",2016-06-16 20:13:08,link,48,26,11,85
52150999700,"Darth Vader is BACK (!!!) in '#RogueOne: A Star Wars Story'—and we have your exclusive first look at absolutely everything in the newest chapter in a galaxy far, far away: share.ew.com/EqtxJDu

Photo credit: Lucasfilm",2016-06-22 07:45:58,photo,122,84,42,248
10606591490,These schools have the highest returns on investment.,2016-06-19 07:30:10,link,122,63,35,220
10606591490,These are the foods you should be eating now.,2016-06-19 14:00:41,link,47,83,1,131
5281959998,"Across Venezuela, cities are erupting in protests and looting over food shortages. Nick Casey, The New York Times's Andes bureau chief, provides a view from the ground.",2016-06-21 19:25:00,video,176,73,45,294
5281959998,"From Orlando to Shanghai, a look back at the week in photos.",2016-06-18 10:25:00,link,185,90,7,282
5281959998,"She was trapped inside a bathroom stall at the Pulse nightclub in Orlando when she locked eyes with the shooter.

To watch the full video, click here: http://nyti.ms/1sIk3FZ",2016-06-16 16:25:00,video,98,27,44,169
86680728811,"A neighbor said she had long felt that ""something isn't right"" at a Bucks County home where a man is accused of sexually assaulting a teenager whose parents police say gave her to him when she was 14.",2016-06-19 05:09:58,link,162,29,16,207
112638779551,"DRAMA: LeBron James rejects Steph Curry, stares him down",2016-06-16 23:01:00,link,131,11,31,173
52150999700,Little Donald J. Trump is SO cute! 😂,2016-06-23 07:45:01,link,59,91,6,156
7245371700,"This week's 'Speed Dial' is ringing with thoughts on LA Pride, Whitney & Bobby, & Spike Lee's '90s filmography.",2016-06-17 16:43:33,link,59,46,8,113
112638779551,It is over. The Cleveland Cavaliers have done it.,2016-06-19 21:38:25,link,129,57,45,231
86680728811,"President Barack Obama in Orlando: ""We have to end discrimination and violence against our brothers and sisters who are in the LGBT community."" http://abcn.ws/23e5mqH",2016-06-16 16:15:35,video,119,85,25,229
25902406772,Derryck Thornton will have a new uniform next season.,2016-06-17 14:46:54,link,14,6,19,39
18807449704,Stunning.,2016-06-23 01:00:00,link,12,32,4,48
5281959998,Bernie Sanders told C-SPAN in an interview that he most likely would not be the Democratic presidential nominee.,2016-06-22 19:25:00,link,172,29,42,243
75932763901,WHOA — can you believe she wore THIS to a red carpet event?! Click here to find out who (via Life & Style Weekly): http://bit.ly/1Yqjw7B,2016-06-15 01:30:00,photo,200,23,27,250
52150999700,Donald J. Trump continues his streak of getting slammed on Late Night with Seth Meyers.,2016-06-21 07:10:00,link,99,53,21,173
5281959998,As many as 5 million unauthorized immigrants could have potentially benefited from President Barack Obama's plan.,2016-06-23 11:45:00,link,167,1,27,195
13652355666,"Philippe taught himself to do hair, one style at a time. Now he's teaching other dads to do the same.",2016-06-19 08:10:00,video,185,46,4,235
52150999700,Mary-Kate and Ashley Olsen have come a very long way since their time at Camp Calloway. ❤️,2016-06-18 20:07:00,link,186,77,12,275
5281959998,"""I have gone back to the pure joy of what I feel when I dance."" 

At 53, the ballerina Alessandra Ferri will return to the The Metropolitan Opera House stage on Thursday night.

Photo: Nicole Bengiveno/The New York Times",2016-06-23 16:25:00,link,188,90,13,291
75932763901,NAKED! Find out who bared all wearing nothing but body paint! —> http://bit.ly/24WxrCd,2016-06-18 01:00:00,photo,78,10,32,120
7245371700,And it's for a great cause.,2016-06-16 09:13:08,link,77,19,37,133
112638779551,"That's one very accurate kick! His reward? A cool $100,000. 

Kristen Balboni for @TheBuzzer",2016-06-16 14:11:41,video,58,100,15,173
13652355666,"""It's really unfortunate that it's happened to our own home country ... but if that's what it takes to makes sports cleaner then it must be done.""",2016-06-17 23:56:56,link,90,69,3,162
13652355666,"After nearly 15 hours, the Senate decided to adjourn until 10 a.m. Thursday.",2016-06-16 01:23:36,link,169,73,8,250
13652355666,Well then.,2016-06-19 02:50:00,link,104,48,20,172
75932763901,"OMG! Ashley Olsen, 30, was spotted getting cozy with a 59-year-old man! —> http://bit.ly/1sGEaEy",2016-06-15 23:30:00,photo,76,33,14,123
18807449704,Talk about a Game of Thrones plot twist!,2016-06-22 14:32:10,link,196,65,37,298
95926963131,"From wild-haired Aussie ingenue to sleek and stylish Oscar winner, see birthday girl Nicole Kidman's amazing transformation!",2016-06-20 14:44:59,video,39,58,46,143
95926963131,A second body has been recovered in the search for a missing family whose sailboat went missing on Sunday.,2016-06-23 16:06:05,link,102,100,19,221
25902406772,"""I've got it! 

.......or maybe you've got it. Yep, you've got it.""",2016-06-22 23:51:44,link,48,32,17,97
10513336322,"""Over the past 30 years there has been a sustained attack on working-class people, their identities, their work and their culture by Westminster politics and the media bubble around it. Consequently they have stopped listening to politicians and to Westminster and they are doing what every politician fears: they are using their own experiences in judging what is working for and against them.""",2016-06-16 04:20:01,link,44,78,43,165
18807449704,Look again. Nope. Look again.,2016-06-19 17:15:19,link,166,54,32,252
112638779551,"John Daly hits a golf ball from a guy's mouth

Kristen Balboni for @TheBuzzer",2016-06-18 17:57:58,video,104,48,1,153
95926963131,Prince Harry is giving us a cuteness overload! (via People Royals),2016-06-18 16:00:21,link,103,95,44,242
10606591490,Anne Hathaway has joined the ranks of Angelina Jolie and Emma Watson.,2016-06-16 12:30:09,link,121,91,44,256
95926963131,"Another shooting has occurred—this time 40 miles south of Frankfurt, Germany. (via People True Crime)",2016-06-23 11:42:06,link,157,90,18,265
25902406772,Cleveland Indians top prospect Brady Aiken is on the right track.,2016-06-15 11:50:54,link,131,54,34,219
7245371700,Anton Yelchin has passed away at the age of 27. May he Rest in Peace.,2016-06-19 14:26:03,link,96,69,27,192
112638779551,"Cleveland Browns quarterback Robert Griffin III wanted to congratulate the Cleveland Cavaliers for winning the title, but he apparently decided to take credit for something he didn't do.",2016-06-20 22:30:13,link,13,11,26,50
10606591490,Game of Thrones could stand to lose out.,2016-06-22 23:30:15,link,76,9,49,134
52150999700,Charlie Sheen is getting VERY candid about his troubled past and time on Two and a Half Men: http://share.ew.com/86xiQv7,2016-06-21 14:38:00,video,37,13,5,55
18807449704,"Firearm attacks are extremely rare in Britain, which has some of the strictest gun laws in the world.",2016-06-18 04:24:41,link,180,73,3,256
25902406772,Ed Reed should be a great addition to the coaching staff.,2016-06-16 15:11:18,link,29,9,48,86
52150999700,Michael Jackson's estate has released a statement.,2016-06-22 20:19:00,link,190,67,29,286
10606591490,"Yelchin played Chekov in the new ""Star Trek"" films",2016-06-19 13:30:24,link,60,28,43,131
112638779551,The United States Golf Association - USGA announces the U.S. Open Championship will return to Oakmont Country Club in 2025 and Shinnecock Hills Golf Club in 2026. #USOpen,2016-06-18 11:53:20,video,98,33,33,164
10606591490,But Tesla doesn't recommend it,2016-06-19 15:30:06,link,199,42,34,275
112638779551,"Ron Lester, who starred as Billy Bob in 'Varsity Blues,' died Friday at age 45.",2016-06-18 10:23:20,link,94,53,7,154
25902406772,Odell Beckham Jr is a monster.,2016-06-21 09:42:37,link,131,77,4,212
112638779551,"Minnesota Twins closer Glen Perkins is having season-ending shoulder surgery today, and no one feels worse about it than he does.",2016-06-23 08:06:25,link,13,63,22,98
13652355666,"Orlando candlelight vigil at Dupont Circle in Washington, D.C.",2016-06-15 19:10:36,video,109,61,11,181
112638779551,Ladders + briefcases = so much pain for these WWE superstars.,2016-06-19 16:38:38,link,76,38,22,136
10606591490,Get it while you can.,2016-06-23 01:00:32,link,174,38,21,233
112638779551,"Royce West reportedly was one of Bryant's Dallas-area mentors, but he's suing for between $100,000 and $200,000.",2016-06-22 15:10:16,link,138,75,42,255
95926963131,It isn't usually news for a singer to show their face during a concert – but Sia isn't like most singers.,2016-06-23 12:48:04,link,191,73,40,304
52150999700,We can't wait to see Justin Long and Ashley Tisdale in this Netflix adaptation! 🙌,2016-06-17 02:47:00,link,181,85,27,293
10606591490,"""When the news is about a brand new little baby, maybe we can forget the price points altogether.""",2016-06-21 14:00:26,link,160,81,15,256
95926963131,Every election season is a gift to the world of comedy. 😂,2016-06-19 05:00:23,link,192,20,39,251
95926963131,"Rose Geil used to hide her excess facial hair, but ditched the razor nine months ago.",2016-06-15 12:50:10,link,53,47,15,115
7245371700,She's like Lizzie McGuire but all grown-up.,2016-06-18 02:35:04,link,129,96,25,250
95926963131,JCPenney is showing that size isn't a measure of a person's worth.,2016-06-21 06:00:35,link,200,95,10,305
112638779551,"LeBron James makes epic guest appearence during Cleveland Indians kiss cam on Monday Night:

http://www.foxsports.com/nba/story/lebron-james-makes-guest-appearence-during-cleveland-indians-kiss-cam-062016",2016-06-21 01:23:59,photo,147,32,11,190
75932763901,CONGRATS! This 21-year-old and her much-older beau are getting ready to welcome their BABY! Find out who —> http://bit.ly/28Jlkpb,2016-06-20 18:30:00,photo,155,84,28,267
86680728811,"Witnesses reported to police that a struggle ensued and the man pulled out a weapon, firing multiple shots and striking the officer.",2016-06-22 17:31:35,link,155,18,15,188
86680728811,"Search for 2-year-old boy taken by an alligator at a Disney World resort is now a ""recovery"" effort, officials say. http://abcn.ws/1XXjdlX",2016-06-15 14:06:15,link,119,65,48,232
52150999700,The Broadway community's incredible tribute to Orlando will bring you to tears. ❤️💛💚💙💜,2016-06-20 07:07:08,link,123,15,19,157
75932763901,One of these characters is returning to 'Grey's Anatomy' for Season 13 — and you'll be ECSTATIC when you find out who (via Closer Weekly) —> http://bit.ly/1UhYJx7,2016-06-18 16:30:00,photo,54,66,9,129
10513336322,Egyptian officials say they have spotted the wreckage of EgyptAir flight MS804 that crashed into the Mediterranean last month.,2016-06-15 15:56:39,link,37,56,6,99
10606591490,"""Starting young made me fearless. You don't know how many ways in which you can fail.""",2016-06-18 21:30:06,link,84,97,21,202
5281959998,One reason: Hillary Clinton needs to improve her standing with white male voters.,2016-06-22 08:26:48,link,111,82,26,219
7245371700,Will the ninth season of Curb Your Enthusiasm change the course of TV comedy?,2016-06-19 20:58:04,link,169,92,11,272
18807449704,Facebook is hiding a minigame in plain sight.,2016-06-15 15:17:21,link,174,88,18,280
18807449704,Prince William is the first member of the royal family to be photographed for this publication.,2016-06-15 09:52:42,link,98,88,22,208
95926963131,It's no secret that Rob Kardashian's sisters didn't exactly welcome his fiancée Blac Chyna to the family with open arms.,2016-06-22 08:06:05,link,187,32,44,263
13652355666,"Whoa! A flash flood turned the staircase of this Washington, D.C. Metro station into a waterfall.",2016-06-22 17:25:00,video,160,13,47,220
52150999700,2pac's influence on the music industry can still be heard today. 🙌🏼  🎤,2016-06-19 00:07:00,link,84,77,46,207
112638779551,"Kyle Van Noy's birthday is in March, which the Detroit Lions didn't know.",2016-06-20 13:21:23,link,156,45,41,242
112638779551,"Could the Cleveland Cavaliers trade Kevin Love this off-season?

Coach Tyronn Lue was asked that question Wednesday, and oh man, was he EMPHATIC with his answer...",2016-06-22 11:00:12,link,163,93,27,283
5281959998,"""When a woman helps another woman, they both benefit. And when women celebrate one another's accomplishments, we're all lifted up,"" write Sheryl Sandberg and Adam Grant in The New York Times Opinion Section.",2016-06-23 13:55:19,link,21,93,31,145
25902406772,HE. HAS. DONE IT.,2016-06-19 22:34:58,video,182,27,25,234
10513336322,What will be done to calm the markets? Will he remain as prime minister? Will he invoke article 50 of the Lisbon treaty immediately? Will parliament be recalled? Who will be in charge of the withdrawal negotiations? Will there be an emergency budget? Will there be an election? Does Cameron accept that the Scots have the right to have a second independence referendum?,2016-06-24 01:00:01,link,64,89,36,189
18807449704,Internet sensation Grandma May has finally received a response to her polite Google search.,2016-06-16 00:16:27,link,84,63,25,172
75932763901,"""The more she drank the less attention she paid to her [child]."" BAD PARENTING?! See which Teen Mom star suffered from an alleged alcohol problem – before she was even 21! –> http://bit.ly/1qgmNbI",2016-06-15 20:00:01,photo,121,81,17,219
95926963131,Fans from Meat Loaf's concert express their concern after witnessing the rock star collapse mid-show. (via People Video),2016-06-18 11:00:00,video,82,43,3,128
10606591490,"Will Smith: ""I found myself promoting something because I wanted to win versus promoting something because I believed in it.""",2016-06-22 16:00:51,link,142,57,45,244
52150999700,Jon Snow is about to have the fight of his LIFE on Game of Thrones.,2016-06-19 11:01:00,link,34,6,44,84
18807449704,"""We've got a visitor, and it's f*cking huge!""",2016-06-21 09:25:48,link,55,79,33,167
7245371700,"""It was Latin night at Pulse. Trump endorsers Marco Rubio and Mitch McConnell did not make the connection that the names of the dead could be confused for a roll call of the families Trump wants to deport.""",2016-06-18 10:08:40,link,114,2,1,117
5281959998,Europe has a 2-tiered refugee policy and the results are deadly. Read on in The New York Times Opinion Section.,2016-06-23 01:55:00,link,190,48,2,240
95926963131,Prince William And Kate Middleton will be quite busy for Father's Day and William's upcoming birthday! (via People Royals),2016-06-19 17:00:00,video,15,76,24,115
52150999700,"Spidey sense, meet Hannibal Buress' sense of humor.",2016-06-21 04:47:00,link,19,14,16,49
112638779551,"""I've thrown my mouth piece before... I usually aim at the scorer's table."" Stephen Curry on the first ejection of his career. #NBAFinals",2016-06-17 00:14:03,video,75,93,17,185
5281959998,"Jo Cox never had a chance to respond when her killer reportedly shouted ""Britain First."" But in a sense, she already had. Read on in The New York Times Opinion Section.",2016-06-21 09:55:00,link,152,81,5,238
18807449704,Her Royal Highness nudged some sense into Prince William.,2016-06-19 22:00:01,link,53,56,45,154
10606591490,"""We will prevail by living our truth and sharing our love—not simply despite the hatred, but because of it.""",2016-06-21 13:00:49,link,34,23,8,65
86680728811,"Records show the Orlando shooting suspect caused trouble at an early age and, as an adult, became a proficient marksman with consistently high scores in tests. http://abcn.ws/1YuWXhX",2016-06-16 12:46:57,link,106,70,42,218
75932763901,"What's happening to Blac Chyna's baby bump? In just a matter of hours, her bump went from THIS to non existent! See the photo —> http://bit.ly/25XPHkl",2016-06-16 08:30:00,photo,161,82,9,252
75932763901,"OMG: One year after their beautiful beach wedding, this celeb reveals he was never LEGALLY married to his famous bride! Find out who (via Life & Style Weekly) —> http://bit.ly/1tqK38S",2016-06-16 04:45:00,photo,63,52,29,144
52150999700,Entertainment Weekly's editors want to know what what our readers LOVE. Grab a seat in our Front Row Panel made just for you. 👌,2016-06-17 06:00:00,link,28,3,24,55
18807449704,"We're showing off our terrible cake decorating skills with Nadiya Hussain, STAR of The Great British Bake Off at the Good Housekeeping Cookery School. Ask her your questions!",2016-06-15 09:36:38,video,16,45,6,67
25902406772,The Minnesota Timberwolves pick up some more young talent in Kris Dunn.,2016-06-23 19:33:39,link,118,80,43,241
25902406772,D'Angelo Russell could remain a member of the LA Lakers.,2016-06-22 09:51:11,link,160,95,18,273
52150999700,Anton Yelchin was best known for his work in Star Trek and Like Crazy.,2016-06-20 00:17:00,link,80,79,29,188
52150999700,Disney's new Frozen ride REALLY makes us want to build a snowman! ⛄️,2016-06-21 15:14:00,link,107,41,1,149
10606591490,The secret to financial freedom.,2016-06-17 20:30:32,link,184,46,20,250
7245371700,Some of your favorite bands are going head-to-head at the Fandom Awards: http://on.mtv.com/28RGGRZ,2016-06-22 14:00:00,photo,148,60,6,214
95926963131,People's List host Jerry O'Connell is here to answer your questions!,2016-06-23 18:51:16,video,24,72,36,132
25902406772,Al Horford will have a hard decision ahead of him with so many options.,2016-06-22 10:58:14,link,171,90,15,276
112638779551,Golden State Warriors snub small ball for their first-round pick,2016-06-23 22:05:14,link,109,52,46,207
5281959998,"""I came back for a reason."" —LeBron James",2016-06-19 22:06:55,photo,90,93,17,200
18807449704,"When Yahoo purchased Tumblr, Marissa Mayer promised ""not to screw it up"" and yet...",2016-06-15 09:03:19,link,3,14,4,21
13652355666,Don't let the little white lies fool you: You probably will check your email on vacation. http://usat.ly/28ShJHv,2016-06-23 16:00:00,video,96,6,21,123
95926963131,Christy Carlson Romano has come a long way since her Disney days! (via People Babies),2016-06-23 17:34:02,link,34,28,38,100
10513336322,"""After a few pints my dad would ask if I remembered my mother. I'd manage a strangled: 'No, not really,' before sipping a drink and looking away. Then we'd return to a more comfortable subject, like how my dad once, allegedly, bench-pressed 266lb.""",2016-06-19 13:30:00,link,68,67,21,156
25902406772,Cleveland Indians may be trying to keep the momentum going from the Cleveland Cavaliers.,2016-06-22 10:20:12,link,172,1,37,210
10513336322,"""What happens when a prime minister tells his country that immigration is much too high, is the source of many of the country's problems, that it has to be massively reduced – and then immigration remains at the same level? Now we know.""",2016-06-22 01:00:00,link,85,84,46,215
5281959998,Dustin Johnson is the winner of the 116th U.S. Open Championship. It's likely that what happened this year will be talked about for years to come.,2016-06-19 20:05:12,link,114,90,18,222
75932763901,SO CUTE! We can't get over Kim Kardashian West's latest photo of Saint! —> http://bit.ly/28TDas2,2016-06-24 01:30:01,photo,140,9,7,156
5281959998,"A decade ago, hyperinflation led to a $100 trillion note. That's 100,000,000,000,000 Zimbabwean dollars.",2016-06-23 18:32:31,link,103,95,42,240
95926963131,The dating landscape is a minefield.,2016-06-17 09:34:05,link,99,72,43,214
112638779551,Kevin Love absolutely loves the Cleveland Cavaliers' new championship belt.,2016-06-22 06:30:00,link,118,97,24,239
18807449704,Jaylen Brown took the road less traveled to start his NBA career.,2016-06-23 22:00:00,link,84,75,42,201
7245371700,Coincidence?,2016-06-20 23:58:01,link,74,33,31,138
75932763901,"Congratulations, Jesse Williams! Get the exciting news (via Closer Weekly) —> http://bit.ly/28Pb4O9",2016-06-21 21:00:00,photo,149,17,15,181
95926963131,"Lane Graves was laid to rest in his hometown of Elkhorn, Nebraska.",2016-06-21 12:15:14,link,185,73,29,287
52150999700,Our favorite reprobate couple on You're the Worst is facing some major change.,2016-06-20 23:36:00,link,46,44,49,139
7245371700,Coincidence?,2016-06-17 10:30:05,link,184,60,19,263
25902406772,"Paul George, welcome to the squad.",2016-06-23 09:13:01,link,80,9,41,130
112638779551,A native of Ohio explains why LeBron James and the Cleveland Cavaliers winning a title is way bigger than sports.,2016-06-20 16:44:30,link,36,77,30,143
75932763901,She is all SMILES! See who looks just like her famous dad! –> http://bit.ly/25cAdss,2016-06-21 19:00:00,photo,43,82,28,153
10606591490,Are you really smarter than a fifth grader?,2016-06-19 01:00:18,link,161,82,19,262
75932763901,"SEXY! This famous mother cannot stop sharing racy photos of herself — and if you think this is revealing, JUST WAIT until you see the rest: http://bit.ly/28Syh1F",2016-06-24 17:00:00,photo,66,51,12,129
52150999700,Frozen + LEGO is a match made in Disney heaven.,2016-06-21 10:36:00,link,94,34,26,154
5281959998,"""Finding Dory"" makes up for any lack of originality with warmth, charm and good humor, our critic says.",2016-06-18 15:25:00,link,123,10,7,140
52150999700,Chris Pratt and his uncanny stunt double go way back!,2016-06-18 04:33:00,link,50,8,27,85
75932763901,"Katy Perry just found a new way to diss Taylor Swift — and her fans aren't happy about it! See what the ""Firework"" singer did this time (via Life & Style Weekly) —> http://bit.ly/28LHiuy",2016-06-21 15:00:00,photo,187,51,28,266
52150999700,"Transformers fans, get ready for battle! These new photos are 🔥🔥🔥. 😱",2016-06-23 09:47:00,link,55,11,1,67
10513336322,The bubble had to burst at some point ...,2016-06-15 03:40:00,link,109,32,27,168
86680728811,"LATEST: British member of Parliament is in critical condition following attack; a 52-year-old man has been arrested, police say. http://abcn.ws/1YuMseq",2016-06-16 10:55:29,link,178,57,22,257
25902406772,The Boston Celtics' draft could go plenty of ways.,2016-06-21 18:12:36,link,194,90,45,329
18807449704,"""Like the female G-spot, finding the P-spot takes practice and communication.""",2016-06-19 03:00:00,link,121,18,31,170
10606591490,"""She was young, courageous, and hardworking. A rising star, mother, and wife""",2016-06-16 19:30:12,link,33,98,11,142
95926963131,A glowing Blac Chyna is embracing her pregnancy curves! (via People Babies),2016-06-19 19:40:03,link,192,67,47,306
18807449704,'HiddleSwift' trends on Twitter and fans are losing it.,2016-06-16 22:00:00,video,133,18,35,186
18807449704,Seriously. This is not a joke.,2016-06-21 15:51:56,link,48,36,10,94
25902406772,"Ronnie Stanley adopted Winter, a dog who lived through some unfortunate situations in her six years.",2016-06-16 14:31:38,link,173,23,17,213
7245371700,A very familiar name has Miley Cyrus's  back - and heart. <3,2016-06-20 08:52:07,link,110,36,8,154
52150999700,Taylor Swift's message to the Orlando victims' families is so touching. ❤️,2016-06-17 18:17:01,link,112,29,41,182
10606591490,Fathers can get a little bit smarter about the minds of their daughters,2016-06-19 10:30:16,link,142,34,30,206
86680728811,"Pres. Barack Obama will sign into law the first overhaul of toxic chemical rules in 40 years that sets safety standards for dangerous chemicals like formaldehyde, asbestos and styrene.",2016-06-22 08:50:31,link,184,8,43,235
52150999700,Brian De Palma originally wanted Don Johnson Official to star in the big-screen version of The Untouchables: http://share.ew.com/I9PI4UD,2016-06-15 06:34:02,video,157,20,10,187
112638779551,Dustin Johnson is only one off the lead at the U.S. Open Championship. Follow him through every hole now on our featured group on FOXSportsGo.com and USOpen.com!,2016-06-17 14:47:41,photo,164,51,37,252
52150999700,This is the PERFECT documentary for all Indiana Jones fans!,2016-06-19 08:31:00,link,42,79,42,163
112638779551,"Von Miller admits his contract dispute with the Denver Broncos ""hurts.""",2016-06-17 11:55:36,link,182,59,25,266
18807449704,The most enjoyable thing about Blake Lively's The Shallows is looking forward to seeing The Shallows — and that is not a dig.,2016-06-23 11:30:00,link,145,2,41,188
75932763901,They're ENGAGED!!! Congratulations to this happy couple! —> http://bit.ly/1WXfgNs,2016-06-20 01:30:00,photo,180,95,19,294
25902406772,JJ Watt shows his support for U.S. Soccer.,2016-06-18 15:22:37,link,66,58,45,169
5281959998,"""We don't know anything about Hillary in terms of religion. Now, she's been in the public eye for years and years, and yet there's no — there's nothing out there,"" Donald J. Trump said.",2016-06-22 03:23:22,link,197,87,12,296
112638779551,"Matthew Stafford doesn't sound overly concerned about Calvin Johnson, Jr.'s retirement.",2016-06-21 11:26:46,link,132,58,15,205
86680728811,"Baltimore Ravens rookie Ronnie Stanley told a local animal shelter he was ""looking for [a] dog that's been here a long time and maybe not-so-adoptable."" He left ""delighted."" http://abcn.ws/1UpgnSH",2016-06-18 19:22:38,link,56,7,34,97
10513336322,"""What is it that has made a third of minority voters – many of them the descendants of immigrants themselves – lean towards leaving?""",2016-06-23 06:40:00,link,140,22,5,167
10606591490,"Selma Blair reportedly had an ""outburst"" onboard the flight.",2016-06-20 21:30:17,link,37,76,27,140
112638779551,This could be the missing link between Ben Simmons and the Philadelphia 76ers. #Betcha,2016-06-23 14:30:45,video,52,18,8,78
86680728811,Increased tourism is bringing needed income to Cuba—but some fear it'll also bring problems.,2016-06-19 12:06:42,link,4,43,7,54
18807449704,Beautiful.,2016-06-22 00:30:00,link,33,60,18,111
25902406772,Jerry Lawler was recently suspended indefinitely from the WWE.,2016-06-17 11:11:55,link,128,29,38,195
86680728811,Google data shows predictable search fatigue following mass shootings. http://abcn.ws/1ZRtVYo,2016-06-15 12:48:54,link,116,75,44,235
52150999700,'Spider-Man: Homecoming' has drawn Michael Mando to its web.,2016-06-22 19:21:00,link,59,62,8,129
95926963131,Everything you need to know about Elizabeth Warren—a rumored pick for Hillary Clinton's Vice President. (via People Video),2016-06-15 10:18:00,video,160,52,27,239
10606591490,The mom and her son were dancing when she was fatally shot in Orlando.,2016-06-21 06:30:27,link,196,97,24,317
52150999700,Rami Malek and Jessie T. Usher are only a few of the hunks you MUST check out on-screen this summer. 😎,2016-06-22 05:25:00,link,14,86,16,116
18807449704,Leonardo DiCaprio is a huge fan 😍,2016-06-15 04:30:01,link,172,6,43,221
52150999700,Alexander Skarsgård is swinging into action in the INTENSE new 'Legend of Tarzan' trailer. 😱,2016-06-20 11:14:53,link,16,88,50,154
10513336322,Ever wondered what the  Girl with a Pearl Earring's behind looks like?,2016-06-16 09:20:00,link,159,67,44,270
10513336322,"""In 1996, Independence Day felt like the end of the world as we knew it. What does it say about current cinema that it now doesn't seem so bad, after all?""",2016-06-18 10:00:01,link,48,38,6,92
10513336322,"""'In the past 12 months have you experienced anything that could be termed stressful?' Ouch. I email back, 'Mother died, new job, child injured by barbed wire needing plastic surgery, wife died.' I suspect this reply will be as welcome on someone's screen as a pile of well-rotted manure.""",2016-06-18 09:00:01,link,64,67,42,173
5281959998,"A 2-year-old boy was attacked and dragged away by an alligator at a lake at a Disney hotel in Florida. ""We're not likely now to find a live body,"" a sheriff said.",2016-06-15 02:55:01,link,171,45,25,241
10606591490,Sometimes the landlord/tenant relationship can be a difficult one. But it doesn't have to be that way.,2016-06-19 17:00:33,link,7,22,50,79
25902406772,Antonio Brown has ditched Big Ben!!!,2016-06-23 14:26:09,link,155,30,5,190
18807449704,Amazing!,2016-06-17 21:00:00,link,38,3,3,44
52150999700,Ellen Page fought back tears while talking about the tragedy in Orlando. ❤️,2016-06-15 14:16:00,link,140,70,34,244
86680728811,"""Everyone in southern Florida knows"" gators could be lurking in or around any body of water, but some say that's not necessarily the case for out-of-town visitors.",2016-06-16 18:36:21,link,11,58,24,93
95926963131,"Happy 34th birthday, Prince William!",2016-06-21 12:37:07,link,73,5,13,91
95926963131,Gwen Stefani celebrated Blake Shelton's big 4-0 with some epic throwbacks.,2016-06-18 16:40:03,link,174,54,8,236
18807449704,HOW?!,2016-06-16 06:36:08,link,105,31,31,167
7245371700,Kylie Jenner's new shades are giving me the ~blues~.,2016-06-21 12:22:21,link,69,45,40,154
52150999700,"From The O.C. to Friday Night Lights, actors and creators mourn the loss of their shows gone too soon: http://share.ew.com/td0lXK3 💔",2016-06-20 18:43:00,video,39,17,23,79
52150999700,This Finding Nemo honest trailer will remind you of all the heart-wrenching sadness from the film. 😭,2016-06-18 16:57:00,link,142,56,40,238
7245371700,"It must be hard to hear with that hat, Selena Gomez.",2016-06-17 08:48:18,link,187,54,42,283
75932763901,Fans are FREAKING OUT over this throwback snap of Kourtney Kardashian — and you have to read the caption to understand why: http://bit.ly/28Jjvvf,2016-06-21 09:30:00,photo,165,75,1,241
25902406772,Game 7 between the Cleveland Cavaliers and Golden State Warriors should be epic.,2016-06-17 00:03:31,link,100,49,41,190
7245371700,"When life gives Beyoncé lemons, she wears them as a headband.",2016-06-21 17:09:44,link,162,25,18,205
7245371700,"""Mother, May I Sleep With Danger? is a mess of half-articulated and half-abandoned ideologies.""",2016-06-21 19:15:07,link,53,8,33,94
5281959998,More working-age men have dropped out of the labor force in the U.S. Why are France and other advanced nations not having similar problems?,2016-06-21 00:55:00,link,97,8,13,118
25902406772,This isn't good news for the Boston Red Sox.,2016-06-19 12:35:29,link,187,30,16,233
10606591490,"The robot has been described as ""kindly, endearing and surprising.""",2016-06-15 01:30:26,link,179,21,42,242
95926963131,"Audra McDonald, Lin-Manuel Miranda and Whoopi Goldberg's voices are so soothing. 🎶",2016-06-19 21:20:05,link,69,52,49,170
95926963131,Ashton Kutcher and Mila Kunis' second child will be a part of such a loving family! ❤️,2016-06-17 04:00:12,link,140,20,40,200
10513336322,The leave campaign insists EU nationals already in Britain would be able to stay – but immigration lawyers say it's not so simple...,2016-06-23 22:44:28,link,197,30,28,255
7245371700,"""We're the biggest band in the world that nobody's ever heard of,"" Healy explains, half joking. 

Read more on The 1975 in our cover story: http://on.mtv.com/28T8x1C",2016-06-22 07:00:00,video,19,100,45,164
5281959998,"On Monday, we talked to the man behind the most hated villain on ""Game of Thrones."" (Spoilers ahead.)",2016-06-20 17:40:00,link,86,41,48,175
5281959998,"""The notion that such a person — any person — should be able to buy a military-style assault rifle is insane."" Read on in The New York Times Opinion Section.",2016-06-15 12:25:01,link,166,92,2,260
10513336322,Follow every result as it arrives in our essential EU referendum live blog.,2016-06-23 16:01:18,link,14,21,33,68
52150999700,Kate Beckinsale has a good explanation for this shocking (and hilarious) admission.,2016-06-15 10:29:00,link,118,11,19,148
7245371700,"All hail King LeBron James, but shout-out to Kyrie Irving for the winning shot.",2016-06-20 15:24:15,video,167,88,23,278
86680728811,Walt Disney World temporarily shutters its resort beach areas and recreational marinas after a 2-year-old Nebraska boy was dragged by an alligator into a lake: http://abcn.ws/1Yrtd5o,2016-06-15 10:54:57,link,175,98,20,293
7245371700,I'm getting a 1950s vibe.,2016-06-20 05:48:39,link,38,50,17,105
18807449704,"""It was time to create counseling based around texting. So we built it.""",2016-06-18 00:00:00,link,147,60,12,219
13652355666,"BREAKING: Baltimore Officer Caesar Goodson Jr. acquitted of second degree murder in Freddie Gray case. usat.ly/28SkKrw  (Photo: Jose Luis Magana, AP)",2016-06-23 09:59:51,photo,147,39,23,209
95926963131,Nick Jonas' favorite Snapchat filter is sure to win you over. (via PeopleStyle),2016-06-19 21:40:06,link,54,57,11,122
112638779551,"The Washington Nationals won a classic against the Chicago Cubs on Wednesday, and afterward the game's hero was fired up.",2016-06-16 05:45:09,link,69,63,42,174
75932763901,Her sister is worth half a BILLION dollars – but she is a homeless former prostitute! Find out who –> http://bit.ly/2923iyg,2016-06-24 21:30:00,photo,187,19,24,230
13652355666,Barbie has come a long way.,2016-06-17 21:13:00,link,21,13,22,56
112638779551,Golden State Warriors ready to make moves to get that crown back,2016-06-22 23:54:30,link,13,84,20,117
52150999700,"Beyoncé gets a little help from Serena Williams while calling out ""Becky with the good hair."" 🍋",2016-06-22 11:26:00,link,42,47,29,118
112638779551,"How sweet it is to have the U.S. Open Championship in town.

The sights, sounds, and of course delicious tastes of Oakmont Bakery, Inc, as presented by The Pittsburgh Steelers head coach Mike Tomlin. #USOpen",2016-06-15 17:51:03,video,106,33,39,178
112638779551,The Colorado Rockies will pay nearly $40 million to Jose Reyes after cutting ties with him.,2016-06-15 12:59:01,link,185,22,10,217
52150999700,"Texas forever! Before Friday Night Lights became a hit TV show, it was one of the BEST high school movies.",2016-06-22 01:14:00,link,77,40,16,133
7245371700,Learn how to recreate retro MTV clothing inspired by Marc Jacobs.,2016-06-16 16:30:01,video,85,89,17,191
18807449704,Tell your friends. Please.,2016-06-16 06:51:21,link,2,49,44,95
25902406772,We have thoughts... you should listen.,2016-06-16 17:51:22,link,174,19,2,195
25902406772,Finnish Baseball is a little different from American Baseball...,2016-06-20 14:22:56,link,122,98,40,260
95926963131,A family ski trip turned into a nasty cat fight amongst the Kardashian sisters in Keeping Up With The Kardashians on E!.,2016-06-20 08:06:04,link,98,49,22,169
52150999700,Rick Astley is rolling his way BACK! 🙌🏻,2016-06-20 21:34:00,link,26,97,7,130
86680728811,U.S. Senate Democrats fed up with inaction on gun controls following another mass shooting turned to one of the only tools they have left: their voice.,2016-06-15 22:20:16,link,129,71,40,240
95926963131,Happy first birthday to Princess Madeleine of Sweden's little one! 👑 (via People Royals),2016-06-15 21:14:15,link,178,87,48,313
7245371700,"Isn't it a little hot out for that, Rihanna?",2016-06-19 20:30:24,link,75,28,21,124
10606591490,Add these to your not-to-do list.,2016-06-18 18:30:05,link,15,8,25,48
7245371700,But it's Britney Spears!,2016-06-16 01:36:19,link,191,95,12,298
75932763901,FEUD ALERT! Kim Kardashian openly disses Taylor Swift in new interview — and the reality star doesn't hold back! —> http://bit.ly/1W203cW,2016-06-16 17:00:00,photo,51,3,12,66
112638779551,"The Cleveland Cavaliers and Golden State Warriors produced a thrilling Game 7 that, according to the league, was perfectly officiated in the final two minutes.",2016-06-20 21:10:09,link,149,51,33,233
5281959998,"A trauma center in Orlando staged a large-scale ""active shooter scenario"" in March. The Pulse shooting turned that drill into reality.",2016-06-20 08:25:00,link,99,78,41,218
18807449704,The little tortoise that could. :),2016-06-18 01:00:00,link,70,3,50,123
86680728811,President Obama and the first family are spending their weekend enjoying Yosemite National Park in California in celebration of the 100th anniversary of U.S. national park system. http://abcn.ws/1QdxVm6,2016-06-18 16:24:10,link,56,48,47,151
7245371700,"HBD, Lana Del Rey <3",2016-06-21 14:21:31,link,194,52,19,265
13652355666,Bernie Sanders: not on the list.,2016-06-21 22:00:00,link,134,95,24,253
18807449704,"Yum, Burger King?",2016-06-22 16:30:00,link,104,75,43,222
18807449704,Elon Musk wants to buy a company he helped start.,2016-06-21 19:23:59,link,194,48,18,260
10606591490,Feeling hungry?,2016-06-19 18:00:39,link,147,66,33,246
86680728811,President Barack Obama has arrived in Orlando to meet with families of shooting attack victims. http://abcn.ws/23e5mqH,2016-06-16 11:49:15,video,40,98,32,170
25902406772,The Cleveland Cavaliers are pulling out all the stops.,2016-06-22 08:39:42,link,61,44,5,110
86680728811,"""This could lead to dozens or hundreds [of infants] born with microcephaly in the coming year,"" CDC Director Tom Frieden says. http://abcn.ws/1XZtcay",2016-06-17 13:30:39,link,186,78,19,283
112638779551,The Rio 2016 Summer Olympic Games will begin on Aug. 5.,2016-06-17 18:54:21,link,118,87,28,233
7245371700,"We need answers, Disney.",2016-06-18 03:27:51,link,84,15,10,109
52150999700,The 'Finding Nemo' honest trailer perfectly captures the heartbreak of the beloved film. 💔,2016-06-15 16:30:00,link,48,71,26,145
7245371700,Keke Palmer is taking over the Internet.,2016-06-18 16:31:01,link,121,50,27,198
112638779551,"Anthony ""Rumble"" Johnson is out of his fight on July 23 against Glover Teixeira at FOX UFC Fight Night in Chicago",2016-06-18 12:23:49,link,127,74,26,227
10606591490,Barack Obama had previously pushed against Brexit.,2016-06-24 10:00:20,link,130,15,50,195
7245371700,"Whoa, that's a lot of dough.",2016-06-17 04:08:05,link,96,67,30,193
25902406772,Zlatan Ibrahimovic will call it quits for Sweden.,2016-06-21 12:35:33,link,193,79,1,273
112638779551,The Golden State Warriors haven't ruled out Andrew Bogut for Game 6 yet.,2016-06-15 05:29:35,link,105,94,25,224
86680728811,"SpaceX chief Elon Musk blames ""early liquid oxygen depletion"" for the crash of a leftover rocket booster attempting to land on an ocean barge. http://abcn.ws/1S8mqXh",2016-06-17 01:35:31,video,62,13,2,77
10513336322,"Financial markets around the globe are plunging after the British people rocked Europe by voting to leave the European Union. The pound has already plunged to a 30-year low. And London's stock market is expected to tumble very, very sharply at 8am when trading begins. We'll be tracking all the financial action, on what could be one of the most dramatic days in the City in decades.",2016-06-23 23:40:09,link,138,47,17,202
25902406772,George really... SPRUNG into action here...,2016-06-15 21:08:40,link,181,56,42,279
10606591490,"""We fell instantly and ferociously in love. At first blush, little about the situation was ideal.""",2016-06-17 17:00:39,link,191,64,21,276
5281959998,The meeting may indicate that Donald J. Trump has modulated his position on gun rights after the Orlando shooting.,2016-06-15 22:25:00,link,65,75,11,151
52150999700,Game of Thrones' 'Battle of the Bastards' episode was INTENSE! Here are our burning questions & theories: http://share.ew.com/EPjNGNe 😱,2016-06-20 17:47:00,video,174,49,31,254
75932763901,OMG! This famous lady didn't leave much to the imagination when she stepped out wearing nothing but BODY PAINT! Find out who she is —> http://bit.ly/24WxrCd,2016-06-17 17:00:00,photo,127,15,41,183
86680728811,"The International Olympic Committee throws its support behind the decision to ban Russia's track and field team from the Rio Olympics and says it will take ""further far-reaching measures"" to crack down on doping ahead of the games: http://abcn.ws/1Y1107a",2016-06-18 12:28:35,link,145,62,50,257
10606591490,"The list includes Bob Dylan, The Cure and Gwen Stefani.",2016-06-21 10:30:20,link,161,100,22,283
112638779551,Hundreds of fans waited for the arrival of LeBron James after the Cleveland Cavaliers won the NBA Finals.,2016-06-20 13:21:54,link,88,15,36,139
10513336322,"""The night before we met, Miller addressed a local Tea Party group, drawing parallels between Brexit and Texit. 'You guys ever heard of Nigel Farage?' he asked the audience. 'Look him up on YouTube – trust me, you will enjoy.'""",2016-06-19 07:40:00,link,63,5,8,76
25902406772,The Los Angeles Dodgers win in very weird fashion.,2016-06-23 08:49:33,link,136,54,9,199
95926963131,President Barack Obama has a scary warning about Yosemite National Park's future.,2016-06-19 08:40:06,link,75,12,42,129
75932763901,"Poor Chris Pratt! When you see what his and Anna Faris' son Jack did to him on Instagram, you'll understand why he can't help but laugh! (via Closer Weekly) —> http://bit.ly/28QwYwp",2016-06-24 07:15:00,photo,84,31,38,153
112638779551,A Texan ranked 624th in the world is leading the U.S. Open Championship at Oakmont by three strokes.,2016-06-16 13:30:52,link,90,14,43,147
13652355666,"Maya, whose father is on a 25-year sentence in a California prison, was one of many children able to send her incarcerated parent a Father's Day video.
#LoveLetters",2016-06-18 11:55:00,link,105,99,41,245
75932763901,Chris Brown's daughter Royalty doesn't look like this anymore! See how much she's grown! –> http://bit.ly/25PxzJE,2016-06-19 11:00:00,photo,70,96,35,201
7245371700,Love you a ~latte~ Gigi Hadid.,2016-06-17 17:11:49,link,175,79,19,273
52150999700,Everyone's favorite foul-mouthed super spy Archer isn't going anywhere!,2016-06-21 13:32:29,link,187,83,27,297
10513336322,Many voters say they don't know who to believe on the EU. Here we examine some of the murkiest referendum claims.,2016-06-15 04:00:00,video,72,84,36,192
25902406772,"In this week's Friday Five, we rank the five Power Five teams that will play the least difficult schedules.",2016-06-17 12:14:48,link,15,32,32,79
112638779551,"The Cleveland Cavaliers victory parade was on Wednesday. 

But why did LeBron James thank L.A. Clippers star Deandre Jordan for helping the Cavs win the championship?",2016-06-22 18:29:57,link,75,75,24,174
13652355666,"""My wife wants me to put a temporary tattoo on it that says 'Broken.'""",2016-06-15 11:07:00,link,100,38,3,141
86680728811,Man who stole $5 worth of ground beef and pizza to feed his family was thrown in jail when he could not pay court costs.,2016-06-22 21:30:49,link,41,18,25,84
112638779551,LeBron James had some words for his critics after winning the NBA title.,2016-06-20 08:49:23,link,185,74,40,299
10513336322,"Last year the city of Rajshahi, in Bangladesh hit a turning point so dramatic that it earned a spot in the record books: according to UN data, the town did more than any other worldwide to rid itself of air particles so harmful to human health.

How did it do it?",2016-06-17 09:20:00,link,126,23,35,184
18807449704,*packing bags*,2016-06-23 02:00:01,link,41,89,5,135
5281959998,"While you're watching England on the field during UEFA EURO, see in real time its chances of advancing to the next round.",2016-06-20 01:15:00,link,96,39,24,159
112638779551,Meet Will Brooks — the newest UFC prospect who has plans to lay waste to the lightweight division,2016-06-15 17:10:41,link,194,86,22,302
86680728811,"The man suspected of killing British lawmaker Jo Cox was a longtime supporter of a U.S.-based. neo-Nazi organization, according to a watchdog group that tracks extremists.  http://abcn.ws/1UpiZ2X",2016-06-18 19:43:45,link,54,91,18,163
18807449704,This smartwatch is teaching kids to manage their time.,2016-06-23 06:00:00,video,188,69,37,294
112638779551,LA Lakers rookie D'Angelo Russell may have ruined Nick Young and Iggy Azalea's relationship... but at least he wasn't afraid to make fun of the incident in this hilarious new commercial...,2016-06-21 10:36:30,link,138,50,1,189
75932763901,"Seriously, Tyra Banks?! She just compared ""model wars"" to a national tragedy... And when you find out what she said, you'll be DISGUSTED —> http://bit.ly/28PSyQF",2016-06-23 19:00:00,photo,140,73,4,217
10513336322,"""Those aged 18-24 are almost half as likely to vote as 65-year-olds. Analysis of last year's general election shows that the young turnout rate in the UK is the lowest of all the 15 members of the old EU. Voters aged 18-24 in Sweden turn out to vote at double the rate of their peers in the UK. This is our chance to shout from the rooftops that our generation deserves to be heard.""",2016-06-20 10:20:01,link,68,28,33,129
10513336322,Bring on the levitating longboat!,2016-06-21 09:40:00,link,40,79,39,158
10606591490,It's North Korea's fifth flop since April.,2016-06-22 02:30:12,link,114,33,44,191
25902406772,The Sacramento Kings get a first round pick for Belinelli.,2016-06-23 18:19:45,link,110,59,23,192
52150999700,Iggy Azalea has officially called it quits with her LA Lakers fiancé. 💔,2016-06-20 08:16:58,link,25,44,16,85
10606591490,Find out if you have what it takes.,2016-06-20 18:00:47,link,65,54,23,142
75932763901,REUNITED?! See what Tyga just revealed about his relationship with Kylie Jenner —> http://bit.ly/1UGzOno,2016-06-18 23:00:00,photo,140,85,4,229
10606591490,India is leading the celebrations.,2016-06-21 04:00:18,link,30,19,16,65
5281959998,"For many Iraqi Sunnis, ISIS isn't some some shadowy and unknowable force. It's their brothers, sons and nephews.",2016-06-18 15:55:00,link,37,56,18,111
112638779551,#DustinJohnson finished strong at the #USOpen this time. What happened?,2016-06-19 20:42:15,link,185,63,8,256
95926963131,Royal dad Prince William of Wales is reflecting on fatherhood with an important message. (via People Royals),2016-06-19 10:00:34,link,28,92,27,147
25902406772,Manu Ginobili may return to the San Antonio Spurs.,2016-06-22 13:20:04,link,69,55,21,145
112638779551,"""When you lose a game in the Finals it feels like Armageddon."" Klay Thompson on bouncing back from the Game 5 loss. #NBAFinals",2016-06-15 17:24:36,video,107,52,10,169
10606591490,How do you deal with out of control kids?,2016-06-18 02:00:43,link,83,14,3,100
112638779551,"Today Colin Cowherd and Jason Whitlock cover Day 1 of U.S. Open Championship, Biggest Game of Stephen Curry's career, and even more ""O.J.: Made in America"" reactions. Watch Speak For Yourself LIVE right now.",2016-06-16 15:56:33,video,16,80,42,138
13652355666,66 times.,2016-06-15 15:10:00,link,11,42,41,94
18807449704,The author of Orange Is the New Black is not happy with Netflix.,2016-06-17 09:36:36,link,175,85,37,297
52150999700,Finding Dory made a HUGE splash at the box office. 🙌  🎥,2016-06-18 16:15:00,link,16,18,1,35
75932763901,They're ENGAGED!!! Congratulations to this happy couple! —> http://bit.ly/1WXfgNs,2016-06-19 17:30:00,photo,24,44,13,81
95926963131,Kendall Jenner and Kylie Jenner honor Caitlyn Jenner on Father's Day.,2016-06-20 08:28:08,link,176,90,44,310
95926963131,This fitness blogger is giving her followers a reality check.,2016-06-22 04:00:09,link,62,36,31,129
112638779551,"LeBron James thanked each one of his teammates after Wednesday's title parade, and things got a little profane",2016-06-22 16:40:48,link,117,17,50,184
13652355666,The Human Rights Campaign office in Washington has been transformed into a powerful seven-story memorial to those killed in the Orlando shooting. http://usat.ly/1VW5ie3,2016-06-18 06:42:56,video,56,6,50,112
86680728811,"Florida assistant state attorney Kenneth Lewis has been suspended by the state attorney's office, after writing on Facebook following the Orlando terror attack that the ""entire city should be leveled. It is void of any redeeming quality.""",2016-06-18 06:03:24,link,65,36,28,129
112638779551,"The Cleveland Cavaliers ended the city's title drought, beating the Golden State Warriors in a Game 7 thriller.",2016-06-19 21:46:26,link,179,88,4,271
95926963131,"Congratulations to new parents Eddie Redmayne and his wife, Hannah! 💕 (via People Babies)",2016-06-19 10:19:43,link,172,53,6,231
7245371700,These are ab-solutely fantastic.,2016-06-18 16:42:06,link,65,88,20,173
75932763901,Say WHAT? Calvin Harris' latest move proves how he REALLY feels about Taylor Swift—> http://bit.ly/28VmEpW,2016-06-23 16:30:00,photo,150,54,33,237
25902406772,Don't mess with the Chicago Cubs.,2016-06-15 14:22:02,link,99,79,40,218
5281959998,Daily Briefing: Here's what you need to know today.,2016-06-15 05:34:42,link,65,65,48,178
52150999700,"Following Christina Grimmie's death, VidCon is committed to making sure everyone's safe.",2016-06-15 05:29:00,link,18,30,20,68
7245371700,Kim Kardashian West was the best dressed in all of the ~ sea ~,2016-06-22 00:10:57,link,42,12,15,69
18807449704,Here's the emotional ending to the gun control filibuster you might have missed.,2016-06-16 12:42:03,link,138,47,14,199
10606591490,This new tool has the potential to change human lives forever.,2016-06-23 10:30:43,link,123,94,7,224
5281959998,Her father had been a tyrant of a man. And then he became a woman.,2016-06-18 07:55:00,link,87,12,36,135
95926963131,Taylor Swift and Tom Hiddleston are heating up!,2016-06-22 15:27:06,link,45,43,16,104
52150999700,"American Gods fans, behold: Your first look at the world of gods on TV is HERE! 🙏🏼",2016-06-16 10:12:40,link,168,42,21,231
13652355666,"One of the hackers said he hopes the imagery will ""brighten peoples' day.""",2016-06-17 17:47:00,link,5,25,40,70
18807449704,Here are Donald J. Trump's words of wisdom to Daniel Radcliffe.,2016-06-21 10:43:08,link,183,74,15,272
7245371700,Blake Lively has expensive taste.,2016-06-15 12:12:24,link,26,97,40,163
10606591490,"Blake Lively also said her 18-month-old daughter, James, is ready to babysit.",2016-06-23 14:30:31,link,127,12,42,181
5281959998,Sports Alert: Derrick Rose is coming to New York. The New York Knicks have acquired the Chicago Bulls point guard to form their own Big 3.,2016-06-22 16:06:38,link,155,42,3,200
7245371700,"""I feel the responsibility to raise my child with values of love, acceptance and compassion, with morals and the confidence to stand up for herself.""",2016-06-19 12:01:19,link,36,48,26,110
95926963131,Mandy Moore and Ryan Adams' marriage is officially over.,2016-06-23 09:08:03,link,127,11,5,143
52150999700,Say goodbye to Star Trek and Notting Hill on Netflix. 👋🏼,2016-06-21 23:20:00,link,42,5,49,96
52150999700,"U2, Taylor Swift and more high-profile stars are ready to battle YouTube.",2016-06-20 14:18:01,link,150,53,33,236
25902406772,"He's much more than an AWESOME name.

The Phoenix Suns just got size and talent in Dragan Bender.",2016-06-23 18:59:40,photo,165,94,4,263
7245371700,"""Who ever thought young Shawn Carter would change the game? Used to rap to the raindrops off my window pane, at the kitchen table late night, no pen, just my brain."" (via Genius)",2016-06-17 06:49:02,link,52,53,37,142
95926963131,The Colorado teen allegedly admitted to shooting his ex-girlfriend twice in the head. (via People True Crime),2016-06-21 17:09:03,link,112,4,5,121
7245371700,"A very special 'Skillset' interview with Michael Shannon talking about his favorite band, Talking Heads (official).",2016-06-17 20:18:29,link,2,25,33,60
13652355666,Constant battle.,2016-06-18 14:04:00,link,135,63,50,248
10513336322,"If you're just waking up, the UK has voted to leave the EU. Follow our essential live blog.",2016-06-24 00:00:00,link,136,51,33,220
18807449704,"The ultimate present for a Game of Thrones fan <hint, hint>",2016-06-21 04:03:47,link,7,95,46,148
7245371700,"And her baby pic is adorable, too.",2016-06-18 11:23:25,link,57,75,36,168
112638779551,Is the U.S. Open Championship Dustin Johnson's to lose? #USOpen,2016-06-18 05:00:00,video,115,67,2,184
52150999700,"Before they were on American Horror Story, The Good Wife and LUTHER, these stars broke through on Law And Order!",2016-06-22 18:40:00,link,145,42,2,189
5281959998,"Britain's exit would be a disaster, the Editorial Board writes in The New York Times Opinion Section.",2016-06-17 06:27:48,link,76,77,4,157
112638779551,"It's Day 3 of #SpeakForYourself

Colin Cowherd and Jason Whitlock have a lot to say about ""O.J.: Made in America,"" Stephen Curry's legacy, and Tom Brady going to the Supreme Court. Watch LIVE right now. 

Don't forget to LIKE the Speak For Yourself Facebook page!",2016-06-15 16:58:23,video,131,89,50,270
95926963131,"One crisis after another is plaguing the Olympics in Rio, which are set to begin in Brazil in just over six weeks.",2016-06-22 20:13:04,link,116,93,33,242
112638779551,David Ortiz has been at fire at the plate but it's what the Boston Red Sox icon did on the bases that earned him a standing ovation Sunday.,2016-06-19 17:37:50,link,121,82,30,233
10606591490,The one word you should stop using immediately.,2016-06-16 06:00:27,link,120,2,18,140
112638779551,"Good pick or nah, Minnesota Timberwolves fans?",2016-06-23 19:09:53,link,117,31,37,185
18807449704,"""It's not fair that the older generation are deciding our futures""",2016-06-24 07:12:37,link,11,15,35,61
13652355666,"The USA TODAY NETWORK is hosting our sixth One Nation event this evening. This time we are in Detroit, and the topic is jobs and the economy. You can watch along via this live stream.",2016-06-15 18:07:18,video,197,88,43,328
18807449704,"""Why do my little ball things hurt when I squeeze them?""",2016-06-21 16:00:00,link,27,51,9,87
52150999700,The decision could cost Led Zeppelin Official a whopping $40 million.,2016-06-22 16:54:00,link,59,31,4,94
5281959998,"""I cannot recommend this enough!"" — Anna, a reader",2016-06-19 16:55:01,link,146,73,3,222
18807449704,Can't fault him for dedication,2016-06-22 04:20:32,link,57,17,18,92
5281959998,"The U.S. men's soccer team beat Ecuador, 2-1, to reach the Copa América Centenario 2016 semifinals.",2016-06-16 22:42:11,link,42,34,29,105
86680728811,"Pedals, the bear that walks upright like a human, has been spotted again in New Jersey. The man who shot this video called the encounter ""really funny,"" but ""scary at first."" http://abcn.ws/28OKgt9",2016-06-22 19:09:35,video,142,53,50,245
7245371700,Can I be their style triplet?,2016-06-21 15:17:13,link,42,70,1,113
7245371700,My eyes have definitely opened up more to who Justin Bieber is as a person.,2016-06-17 05:18:52,link,47,27,24,98
18807449704,"Amy Schumer swaps lives with Vogue editor-in-chief, Anna Wintour.",2016-06-19 12:19:59,video,140,1,38,179
18807449704,UGH.,2016-06-21 17:06:44,link,102,74,15,191
25902406772,Drew Brees is all for going for two more often.,2016-06-16 09:11:57,link,182,44,4,230
25902406772,The Boston Celtics will keep their No. 3 pick,2016-06-23 19:09:41,link,177,86,21,284
5281959998,5-5-5-5. The code for a firefighter killed in action. A chief lost on 9/11 will finally get a funeral.,2016-06-16 17:25:00,link,83,80,47,210
52150999700,History is being made on Broadway! 🙌🏻,2016-06-15 14:36:01,link,36,96,20,152
52150999700,Rihanna was just feeling all of the feels. ❤️,2016-06-21 22:33:03,link,164,15,16,195
52150999700,We can't wait to see Amy Adams' intense role in the Blade Runner director's newest film! 😱,2016-06-17 01:02:00,link,85,85,12,182
5281959998,A parent's comments on a daughter's weight can have repercussions for years afterward.,2016-06-16 09:25:00,link,73,36,4,113
86680728811,"Lack of research funding goes back to 1997, when Congress passed bill that barred the CDC from any research that will ""advocate or promote gun control.""",2016-06-17 00:20:50,link,93,49,36,178
25902406772,Kyrie Irving says he was in a Kobe Bryant state of mind during Game 7.,2016-06-20 16:39:04,photo,10,3,3,16
112638779551,"Andre Iguodala missed practice with a back issue, but Steve Kerr expects him to play in Game 7:",2016-06-18 15:37:54,link,93,35,7,135
10606591490,Tired of those expensive cell phone bills?,2016-06-16 10:00:13,link,78,98,3,179
13652355666,"Believeland celebrates its first professional sports championship in 52 years. (Photo: Tony Dejak, AP) 

More news you need to know: usat.ly/28O05nt",2016-06-22 06:10:00,photo,161,48,13,222
95926963131,Nick Cannon is opening up about co-parenting with Mariah Carey.,2016-06-17 17:16:40,video,192,8,47,247
52150999700,Person of Interest is gearing up for its biggest battle YET! 😱,2016-06-21 09:16:01,link,192,42,16,250
10606591490,What you need to know about whether it's right for you.,2016-06-17 23:30:07,link,138,49,27,214
112638779551,The Houston Astros rightfielder made a fantastic catch on Friday.,2016-06-18 00:05:16,link,103,14,50,167
18807449704,Not your average burrito.,2016-06-17 03:00:00,link,42,55,3,100
95926963131,Paul Santamaria was feeding ducks at Walt Disney World in 1985 when an alligator attacked him.,2016-06-16 16:33:04,link,60,76,45,181
112638779551,A jury found him guilty on all eight charges after four and half hours of deliberation.,2016-06-19 10:11:06,link,162,40,18,220
18807449704,An alligator dragged a toddler into the water near Disney's Grand Floridian Resort & Spa in Orlando Tuesday evening.,2016-06-15 00:38:29,link,95,68,21,184
18807449704,Now go get yourself some free entertainment.,2016-06-19 14:58:17,link,132,19,6,157
25902406772,Gordon Hayward may not be on the move,2016-06-22 09:02:15,link,187,22,6,215
25902406772,Back in 2014 Steve Kerr had some high praises for LeBron James.,2016-06-18 20:49:45,photo,37,7,26,70
7245371700,Selena Gomez's Carpool Karaoke legit had twists and turns.,2016-06-21 09:01:29,link,120,24,16,160
25902406772,Seattle Seahawks DE Michael Bennett's mind isn't necessarily on a new deal.,2016-06-15 08:29:36,link,167,65,32,264
52150999700,Happy 38 years of Grease and Rydell High! 🎉💃,2016-06-16 21:59:00,link,16,41,10,67
112638779551,México were dealt their worst-ever loss in a major tournament. #Copa100,2016-06-19 00:16:18,link,74,37,28,139
10606591490,She was so happy that she teared up.,2016-06-22 08:00:55,link,59,22,50,131
75932763901,We're used to seeing North West with her hair up in a bun — but wait until you see what she looks like when she lets down those gorgeous curls! —> http://bit.ly/25XsL4L,2016-06-15 09:00:00,photo,28,60,25,113
112638779551,Think today's NBA is too soft? Commissioner Adam Silver explains why the league has changed -- and why Draymond Green missed Game 5.,2016-06-16 12:55:43,link,160,79,49,288
75932763901,"This picture of Kylie Jenner is getting A LOT of attention — and when you see the caption, you'll understand why fans are FREAKING OUT —> http://bit.ly/1W3LRQs",2016-06-18 00:05:00,photo,79,36,46,161
112638779551,"When Stephen Curry fouled out of Game 6, Ayesha Curry decided she'd had enough.",2016-06-16 22:57:15,link,82,74,14,170
25902406772,Oh what could have been.,2016-06-23 13:27:04,link,19,38,47,104
112638779551,Muhammad Wilkerson voices his frustration with the New York Jets.,2016-06-16 08:48:12,link,168,90,6,264
5281959998,"Just hours after the music at the Orlando nightclub was interrupted by gunfire, Carvin Casillas peered across his dinner table.
 
""Dad,"" he said, ""I'm kind of gay.""",2016-06-21 20:00:18,link,155,14,29,198
86680728811,"Wisconsin skydiver falls short of completing goal of 300 jumps in 24 hours, but he still managed to accomplish another feat: raising $130,000 for Parkinson's disease research. http://abcn.ws/1URoBmv",2016-06-17 03:31:38,video,70,55,6,131
25902406772,"IS THE NBA RIGGED???

Metta World Peace has a message for all the conspiracy theorists out there...",2016-06-17 14:48:20,video,44,20,28,92
112638779551,We are excited to unite with #SU2C for their fifth live telecast!,2016-06-16 11:58:27,video,140,14,33,187
5281959998,"""The betting is just massive.""",2016-06-23 00:55:00,link,119,62,40,221
10513336322,"""Like his supporters, Bernie Sanders is just getting started. I'm excited to be a part of where we're headed.""",2016-06-17 14:00:00,link,86,81,18,185
112638779551,"He just can't miss! Clay is a master of half-court shots. 

Rachel Bonnetta for @TheBuzzer",2016-06-23 16:02:49,video,197,82,18,297
5281959998,What does Bernie Sanders want in return for endorsing Hillary Clinton?,2016-06-16 07:25:00,link,9,52,2,63
112638779551,"Smylie Kaufman's team busts out the power tools to keep the golfer healthy for the U.S. Open Championship!

(via PROcast)",2016-06-15 18:35:36,video,163,31,46,240
112638779551,"Former UFC champ Anthony ""Showtime"" Pettis makes his featherweight debut at FOX UFC Fight Night in Vancouver",2016-06-15 14:05:16,link,83,79,16,178
25902406772,The world reacts to the Cleveland Cavaliers thrilling Game 7 victory.,2016-06-19 23:37:09,link,170,75,11,256
10513336322,"""It was bonkers. Everyone was having a great time and the kids were chasing after the ducks as they went down the river. Suddenly a police car came along.""",2016-06-22 08:20:00,link,172,7,45,224
95926963131,Here's what we can do to keep guns out of the hands of killers.,2016-06-16 06:00:56,link,21,41,10,72
86680728811,Federal government releases new rules that clear the way for non-recreational drone users to take their unmanned aircraft to the skies.,2016-06-22 02:08:10,link,89,75,19,183
7245371700,These pics of Taylor Swift and Tom Hiddleston don't lie.,2016-06-15 19:10:35,link,52,44,7,103
7245371700,But who are the Pop-Tarts for?,2016-06-23 01:45:24,link,46,98,20,164
10513336322,"'Among the brayingly entitled half-jock, half-future-Congressman hybrids featured, baseball caps are still worn backwards and Miller Lite is drunk from a training shoe for a dare. Everybody is loudly heterosexual and one frat house features a fish tank built into its bar (as if in tribute to the one in Animal House) and a shelf of empty vodka bottles to ""showcase what we drink"".'",2016-06-22 10:00:00,link,162,52,46,260
95926963131,"The young woman battling Crohn's disease has used her $20,000 college fund to make magical moments for other patients.",2016-06-19 22:00:33,link,7,90,44,141
18807449704,Bastard battles don't come easy.,2016-06-20 20:10:00,link,158,48,38,244
10606591490,They agreed to open a dialogue among Muslims on the island.,2016-06-20 04:00:17,link,59,34,21,114
112638779551,"From the tee to green, Lexus has you covered. Tune in LIVE in VR to FOX Sports broadcast using the NextVR app now!",2016-06-18 09:55:48,link,13,57,14,84
7245371700,Troian remains candid that this season of Pretty Little Liars will be her last.,2016-06-21 10:33:54,link,80,32,1,113
112638779551,"Stephen Curry's new sneakers might not be a hit on the Internet, but New England Patriots star Tom Brady appears to love them.",2016-06-16 21:51:52,link,181,41,47,269
112638779551,"Cody Zeller tells awkward draft-day story about the time he spoke to Michael Jordan after being selected

http://www.foxsports.com/nba/story/cody-zeller-tells-awkward-draft-day-story-about-meeting-michael-jordan-062316",2016-06-23 16:04:34,link,78,20,38,136
95926963131,Get this America's Got Talent contestant on the comedy circuit stat! 😂,2016-06-15 21:38:51,link,52,74,1,127
5281959998,"""It's not easy for me to get up in front of a crowd of people. It used to bother me a lot, but now I've got it figured out that God gave me this talent to use, so I just stand there and sing."" — Ella Fitzgerald",2016-06-15 15:10:00,link,12,64,50,126
10513336322,"""We were beaten by more than 20 men with pipes in their hands, beer bottles were broken on our heads, I don't even know how we made it out.""",2016-06-18 12:00:01,link,129,14,11,154
10606591490,Is your favorite band on this list?,2016-06-18 03:00:36,link,70,93,45,208
95926963131,Varsity Blues' Ron Lester has died at age 45.,2016-06-18 08:40:04,link,37,76,7,120
52150999700,Try watching Ricky Gervais impersonate these celebrities and NOT laugh.,2016-06-18 12:15:00,link,119,30,12,161
95926963131,"Matt Damon, Joaquin Phoenix, Rooney Mara and more want your help in stopping this disgusting tradition.",2016-06-19 19:00:41,link,148,51,2,201
75932763901,Tyga quickly deleted a scandalous photo of Kylie Jenner after he posted it to Snapchat — but not before we could get a screenshot! See it here —> http://bit.ly/28RtlVL,2016-06-24 10:30:00,photo,160,53,41,254
95926963131,We're getting the chills listening to Christina Grimmie's beautiful voice.,2016-06-15 04:00:44,link,199,42,2,243
10606591490,Remember that time she broke the Internet?,2016-06-19 20:01:18,link,86,1,15,102
112638779551,Vin Scully got a foul ball and made one Los Angeles Dodgers fan's night.,2016-06-23 09:05:09,link,166,100,47,313
25902406772,Gareth Bale drilled a long free kick.,2016-06-16 09:10:05,link,196,20,30,246
13652355666,"After 100 years, Boeing is still flying high. http://usat.ly/28JtXhA
(Photos: Boeing)",2016-06-20 14:53:00,photo,69,87,37,193
10606591490,It was based off of a real-life Roman war.,2016-06-20 14:30:21,link,139,16,36,191
7245371700,Probably the weirdest Game of Thrones hangout session ever.,2016-06-18 14:11:27,link,192,27,44,263
52150999700,Wishing Meat Loaf a speedy recovery.,2016-06-17 08:51:00,link,12,77,22,111
7245371700,The next generation of Spy Kids is in the making.,2016-06-16 15:09:15,link,39,58,11,108
10513336322,"""This situation of captivity is degrading for the animals.""",2016-06-23 15:00:00,link,136,100,46,282
112638779551,"It's close, but the oddsmakers aren't counting on the Cleveland Cavaliers to repeat as champions next year.",2016-06-20 12:23:18,link,109,29,28,166
52150999700,Full Frontal with Samantha Bee isn't afraid to be controversial—especially when it's a matter of life and death.,2016-06-21 07:30:00,link,10,99,38,147
112638779551,"The further you go, the harder it gets. Kobe Bryant knows. 

Can U.S. Soccer take down its biggest challenge in years in Leo Messi and Argentina? A spot in the Copa América Centenario final is on the line. Coverage starts 7pm ET on FS1! #Copa100",2016-06-21 17:04:54,video,118,39,25,182
10513336322,"""You had all those innocent lives lost. I just felt there's something I could do against the Islamic State to defend those people.""",2016-06-17 05:40:00,link,190,24,41,255
10513336322,"Prince William: ""No one should be bullied for their sexuality or any other reason and no one should have to put up with the kind of hate that these young people have endured in their lives.""",2016-06-15 12:40:00,link,143,58,22,223
18807449704,SO BIZARRE.,2016-06-15 21:20:01,link,84,42,15,141
86680728811,Tesla CEO Elon Musk says the new Model S floats well enough to double as a boat for short periods of time - but they don't recommend it.,2016-06-20 10:31:26,link,44,2,9,55
18807449704,When your mom doesn't know about Snapchat 😂,2016-06-22 07:34:01,link,134,15,42,191
112638779551,"Here's a sight for sore eyes, New York Giants fans",2016-06-15 19:02:43,link,139,19,27,185
5281959998,To patent cow urine isn't just silly. It also endangers India's remarkably innovative patent system. Read on in The New York Times Opinion Section.,2016-06-17 03:55:00,link,75,72,6,153
25902406772,Stephen Curry and Steve Kerr both get fined for letting the refs have a piece of their mind.,2016-06-17 11:01:09,link,7,17,9,33
18807449704,*grabbing tissues*,2016-06-21 02:30:00,link,145,15,47,207
18807449704,"KFC, Colonel Sanders looks a bit different...",2016-06-23 11:00:00,link,22,51,12,85
52150999700,Rory Feek of Joey+Rory powerfully remembers his late wife in this moving documentary. 🙏,2016-06-16 21:10:00,link,113,47,29,189
10606591490,"""Technology has made us able to do more while understanding less about what we are doing.""",2016-06-22 05:30:30,link,176,42,4,222
7245371700,Kodak black's new track reminds everyone that male friendships can still exist in rap music.,2016-06-20 17:11:01,link,32,13,14,59
25902406772,Tom Brady is a big Stephen Curry fan.,2016-06-16 22:04:43,link,83,13,39,135
95926963131,Beyoncé and JAY Z know how to start off the summer.,2016-06-21 08:13:11,link,143,41,16,200
25902406772,Don't mess with Baltimore Ravens WR Steve Smith.,2016-06-23 13:03:34,link,123,35,46,204
10606591490,"""I am a flawed human being who makes mistakes and am filled with shame over this incident.""",2016-06-22 08:30:22,link,136,78,1,215
52150999700,"Don't worry, Penny Dreadful fans, you're not alone.",2016-06-20 22:35:00,link,99,54,42,195
52150999700,Will Smith isn't a Wild Wild West fan for an important reason that changed his career.,2016-06-22 15:12:00,link,25,93,9,127
52150999700,We hope Christina Grimmie's memorial will remember the talent of The Voice star.,2016-06-17 14:18:00,link,185,49,29,263
10513336322,"""I'm mortified by today's vote, but I'm not surprised by it.""",2016-06-21 02:42:00,link,12,73,36,121
10513336322,"""I tried a lot of cute names – Flowers, Tulips – but none of them fitted. I knew I wasn't helping the situation by naming her Quasi Modo, but it stuck.""",2016-06-17 08:20:00,link,92,69,1,162
25902406772,"The San Diego Padres are having a rough year, but not Will Myers!",2016-06-21 12:30:05,link,200,47,1,248
25902406772,An interesting strategy by Notre Dame Football.,2016-06-15 11:07:22,link,51,21,24,96
10513336322,"Roland Emmerich: ""I was successful in Hollywood and when I came back to Germany, they all had to eat their words.""",2016-06-18 13:40:01,link,30,76,32,138
112638779551,Jack Nicklaus' first professional win came at the 1962 U.S. Open Championship in a playoff vs Arnold Palmer. #LookAgain,2016-06-15 14:00:00,video,34,45,2,81
10513336322,"""Anton Yelchin's charm and openness as a performer had earned him a wide following: he had a gentle, at certain angles almost babyish face: a cherubic face in fact, with its flecks of bum-fluff, which nonetheless was growing leaner and more chiselled as he was growing into his late 20s. How grim that thought is now...""",2016-06-20 02:00:01,link,103,61,49,213
13652355666,Adventure awaits.,2016-06-18 13:29:00,link,189,7,28,224
86680728811,"'Strawberry Moon' syncs with the summer solstice for the first time in decades. http://abcn.ws/28K4vr4

ABC7's helicopter captured the full moon rising above the smoke and ash caused by a pair of massive wildfires.",2016-06-21 01:35:28,video,70,62,43,175
5281959998,"An eatery in Mexico is selling Donald J. Trump tacos. They are made with a little cow brain, some pig snout and a lot of tongue.",2016-06-22 10:25:00,link,10,19,46,75
52150999700,"Oprah Winfrey says ""I'm with her!""",2016-06-16 13:50:19,link,186,67,1,254
112638779551,"70-year-old Crayton Taylor sets a new world record like a boss lifting 507 pounds!

Andy Nesbitt for @TheBuzzer",2016-06-22 16:42:33,video,34,93,2,129
25902406772,Some spot-on D'Angelo Russell phone humor in this one.,2016-06-21 12:00:50,link,121,97,24,242
5281959998,"Hamilton: An American Musical fans: It's almost time to say farewell to Aaron Burr, sir.",2016-06-19 15:55:00,link,53,97,38,188
10513336322,"""Even if the remain side wins, it will not say anything much about the essential condition of the country, aside from underlining how divided we are. So please: in that event, no crowing about a resounding triumph, or delusional thinking about a country miraculously restored by the weekend to a state of political harmony. We are in a terrible mess, and it is probably going to take decades to even begin to put things right.""",2016-06-23 03:40:00,link,102,20,40,162
10606591490,Grab a scent and smell like your favorite Star Wars character.,2016-06-15 03:00:13,link,193,4,45,242
25902406772,The NBA Finals are a lot like Game of Thrones.,2016-06-18 12:27:02,link,58,37,11,106
10513336322,"""The left can't see that a steel plant closing, or the boarded-up shops of the east coast, or the eastern Europeans in the Fen towns picking peas in return for a box of chicken and chips have resulted in another type of anti-globalisation protest, which is, of course, Brexit.""",2016-06-16 06:20:01,link,90,10,26,126
18807449704,Shape your own wooden furniture with Magic Sticks.,2016-06-17 17:00:00,video,144,29,13,186
112638779551,One click away. Download FOX Sports Go from the App Store and watch LIVE #USOpen coverage all weekend.,2016-06-18 07:49:19,link,59,93,3,155
10606591490,"""I exploited that to its fullest.""",2016-06-22 10:30:16,link,182,86,27,295
18807449704,It's not all glitz and glamour in Hollywood.,2016-06-16 12:00:00,link,178,86,14,278
86680728811,DOGGONE EXCITED: Police dog can't control his excitement while being reunited with his dog handler after a 2-week separation. http://abcn.ws/28MKmT4,2016-06-22 13:25:16,video,8,41,34,83
25902406772,It's getting to be crunch time at the U.S. Open Championship.,2016-06-17 22:39:27,link,68,57,37,162
112638779551,The best way to deal with the greens at Oakmont? Avoid them entirely by landing the ball in the cup.,2016-06-16 10:05:25,link,191,30,50,271
112638779551,A bare-handed catch on a funny hop is worth watching.,2016-06-21 07:25:24,link,49,73,2,124
112638779551,Watch WWE's John Cena do his best Hulk Hogan impersonation,2016-06-15 09:01:43,link,80,94,5,179
112638779551,"""He's (Dustin Johnson) is hitting 9-iron in.""

Go inside a conversation with Jordan Spieth and caddie Michael Greller. #LookAgain",2016-06-18 14:11:16,video,7,81,8,96
5281959998,"Wilfredo Ruiz is a Puerto Rican Muslim, a lawyer, and the communications director for The Council on American-Islamic Relations in Florida CAIR Florida. He's joining us for a conversation about the Orlando shooter and reaction from the Muslim community in Fort Pierce. Please share your questions for him in the comments.",2016-06-15 16:03:46,video,123,75,8,206
7245371700,Remedies to summer style problems. (via MTV UK),2016-06-21 06:18:31,video,41,64,41,146
10606591490,2. The dumb jock is a myth.,2016-06-18 20:30:05,link,129,100,11,240
25902406772,The LA Lakers are bringing Brandon Ingram to Hollywood.,2016-06-23 18:45:20,photo,123,87,36,246
10513336322,"""Over the course of this unlikely campaign, I covered more than 50 Bernie Sanders events for the Guardian. It was a only a fraction of the several hundred rallies that this 74-year-old and his wife Jane clocked up, but it was enough to encounter a remarkably consistent explanation for his ultimate victory in 22 states as he fought Hillary Clinton for the Democratic nomination for president.""",2016-06-17 08:40:00,link,123,4,28,155
112638779551,"The mysterious power of superstition, when you don't keep score and more.",2016-06-16 07:55:35,link,26,41,30,97
10606591490,She's too cool for the pool.,2016-06-16 00:00:16,link,51,6,12,69
25902406772,Respect.,2016-06-19 22:39:00,link,133,33,26,192
13652355666,It started with a traffic stop.,2016-06-21 08:34:00,link,122,44,24,190
75932763901,"SURPRISE! Justin Bieber just introduced his fans to his ""daughter."" Full story here —> http://bit.ly/1TTODTC",2016-06-22 00:30:00,photo,31,53,5,89
86680728811,"The CIA has released some 50 documents on its former ""Detention and Interrogation"" program; the revelations range from techniques for what has euphemistically been called ""enhanced interrogation"" to the finding that the CIA detained the wrong individual for months.",2016-06-15 20:23:21,link,195,59,47,301
5281959998,"The Senate on Monday failed to advance 4 separate measures aimed at curbing gun sales, the latest display of congressional inaction after a mass shooting.

Read more: http://nyti.ms/28JWNlK",2016-06-20 19:26:00,photo,43,99,34,176
7245371700,The Supreme Court has to address these 3 main issues before its summer recess.,2016-06-21 16:18:39,link,165,39,38,242
18807449704,We can all totally relate to this dog.,2016-06-18 20:00:00,link,135,97,27,259
52150999700,The shocking season finale of Penny Dreadful was the show's last episode ever. 😱,2016-06-20 10:22:58,link,190,98,33,321
13652355666,"Curry will typically give himself five attempts to make his trick shot from the tunnel, and if he misses all five, he'll head back to the locker room.",2016-06-19 19:08:33,link,97,85,29,211
13652355666,Absolutely devastating.,2016-06-15 15:44:47,link,12,80,15,107
10513336322,The photographer who took the shot of refugees walking into Slovenia talks about what it means to him... and how he feels about Ukip using it on its Brexit poster.,2016-06-22 07:20:00,link,61,64,36,161
75932763901,TOO CUTE! This star just shared a rare photo of his three-month-old son! Find out who (via Closer Weekly) —> http://bit.ly/1Q1gTHC,2016-06-15 04:00:00,photo,185,25,38,248
86680728811,"A Pennsylvania man was arrested and charged with sexually assaulting a teenage Amish girl. Police say she was ""gifted"" to him and fathering two children with the victim: http://abcn.ws/1Uo5XTm",2016-06-17 22:04:09,link,59,98,33,190
112638779551,"Eric Decker still supports Ryan Fitzpatrick, but he hints that the contract situation has become a distraction for the New York Jets.",2016-06-15 10:02:33,link,180,92,31,303
52150999700,Taylor Swift was breaking the rules early on in her career. 💪🏼  🎶,2016-06-19 13:09:00,link,163,23,15,201
25902406772,Cristiano Ronaldo was soooo close.,2016-06-18 16:10:51,link,93,57,41,191
95926963131,"Matthew McConaughey says he was not looking for a relationship, but love found him.",2016-06-22 21:00:00,video,30,47,45,122
86680728811,"""My 6-year-old son likes to wear nail polish. He likes to wear girls' clothes and tutus. He tells me about the boys he likes at school. He says he will marry them and adopt babies. Maybe he will outgrow it. Maybe not. I love and accept him for who he is...show him love. Show him acceptance. Help us change the world into one that deserves him.""",2016-06-22 10:58:50,link,186,27,24,237
13652355666,Who knew coffee could make you rich?,2016-06-22 10:50:00,link,58,66,49,173
10513336322,"""Who is the hero? Can you skip the boring bits? How long will it take to read?""",2016-06-20 12:30:00,link,10,31,26,67
7245371700,"There's societal shaming of people who aren't considered ""smart"" and it needs to stop. (via The Atlantic)",2016-06-22 13:39:03,link,38,37,35,110
25902406772,David Wright could be out for the season.,2016-06-16 10:28:35,link,23,50,30,103
7245371700,Is Blake Lively Hollywood's perfect woman?,2016-06-22 15:53:03,link,161,56,39,256
18807449704,YIKES. 😫 😫,2016-06-19 23:00:00,link,96,52,39,187
95926963131,Bindi Irwin posts a touching Father's Day tribute to dad Steve Irwin nearly 10 years after his death. (via People Video),2016-06-20 20:36:00,video,35,33,18,86
5281959998,"""I do think she really likes Dad and maybe even cares for him. But I also think she sees a payoff.""",2016-06-22 20:25:00,link,182,2,5,189
75932763901,"""I was 14 or 15 [when I first smoked crystal meth]."" She's a member of an extremely high profile family – but we had no idea she had a MAJOR drug problem–> http://bit.ly/1UdUIKR",2016-06-19 21:30:00,photo,3,66,47,116
112638779551,"Seth Rollins tore Cleveland apart last June. A year later, the Cleveland Cavaliers are king and the WWE Superstar will have to live down an eight-second title reign.",2016-06-20 09:17:46,link,175,56,38,269
75932763901,TOO FAR? Kanye West's latest attack on Taylor Swift is seriously over the line — and her fans are going to be FURIOUS: http://bit.ly/28Leo7U,2016-06-22 09:00:00,photo,167,71,17,255
112638779551,"#NASCAR drivers play ""food roulette"" ... eat cat food. #NASCAR",2016-06-22 14:41:34,link,151,79,2,232
112638779551,"With Game 7 tied with less than a minute remaining, Kyrie Irving hit the deciding shot:",2016-06-19 23:58:24,link,17,89,45,151
25902406772,Doug Gottlieb doesn't have Brandon Ingram in the Top 2. So.. who?,2016-06-16 16:02:49,link,84,9,3,96
7245371700,No one's immune to a mean Instagram comment.,2016-06-19 20:09:20,link,111,66,2,179
25902406772,It's almost game time between the Cleveland Cavaliers and Golden State Warriors.,2016-06-16 19:14:26,link,155,60,40,255
10606591490,"It's called ""broken heart syndrome.""",2016-06-19 16:00:57,link,198,28,13,239
10513336322,"The world has more than 40 million miles of road. 

What would life be like if those roads could all act as solar panels?",2016-06-15 03:20:00,video,115,22,33,170
10513336322,"""People started yelling: 'Refugees!' So I went. Lots of children were crying. That was the moment I realised we had to do something.""",2016-06-18 02:40:00,link,148,15,37,200
7245371700,Cheers to more Taylor Swift + Tom Hiddleston Beyoncé dance-offs.,2016-06-16 09:37:48,link,180,16,9,205
7245371700,Greenleaf OWN proves that there's no drama like church drama – especially on TV.,2016-06-21 20:52:05,link,87,4,15,106
112638779551,Cleveland Cavaliers fans have turned downtown Cleveland into a  jungle gym.,2016-06-22 13:22:08,link,43,74,30,147
10513336322,"A group of Muslim women who claim in a lawsuit they were kicked out of a California restaurant for wearing headscarfs have been accused of ""civilizational jihad"" by a lawyer for the restaurant, which has launched a countersuit.",2016-06-23 18:20:01,link,54,47,46,147
7245371700,"Luckily, there is a solution and many states are getting with the program.",2016-06-15 08:07:55,link,102,95,50,247
10606591490,"Get excited, Star Wars fans.",2016-06-22 20:00:53,link,103,2,34,139
10513336322,"""Many scientists will be eager to get more data on how his body and mind have reacted to his time in space. But first, Tim must adapt to living on Earth again.""",2016-06-19 10:03:00,link,118,78,28,224
7245371700,The Flash even has Batman's heart.,2016-06-23 03:30:20,link,6,48,10,64
95926963131,"Executive Editor Kate Coyne is live to dish on her new book, ""I'm Your Biggest Fan,"" and answer your burning questions about her most memorable (and most awkward) celebrity encounters!",2016-06-22 12:34:20,video,18,2,7,27
7245371700,The things Kylie Jenner does for fashion.,2016-06-22 15:37:28,link,106,33,35,174
5281959998,Netflix changed the way we watch TV. But it can't stop there.,2016-06-15 09:26:09,link,131,83,29,243
10606591490,Protest concert by Cantonese pop star and democracy advocate Denise Ho,2016-06-19 02:18:15,video,27,87,47,161
112638779551,Shaq has never looked so good.,2016-06-23 08:56:25,link,194,58,36,288
112638779551,"Tonight, their lives changed forever. Congratulations to all of the 2016 NBA draftees! 

Welcome to the show.",2016-06-24 00:08:52,video,34,64,21,119
86680728811,"Authorities in Phoenix searching for 2 men suspected of setting fireworks ablaze inside Walmart store. ""A prison sentence for this could be up to 20 years."" http://abcn.ws/1UczXiN",2016-06-17 02:21:40,video,52,66,7,125
7245371700,They go a little more in-depth into Marissa's tragic storyline and the fight to keep one iconic controversial scene in season 1.,2016-06-20 07:35:39,link,138,79,18,235
75932763901,SHE POPPED! This glowing mommy-to-be just can't hide her baby bump anymore! —> http://bit.ly/28VK7Y0,2016-06-23 18:30:00,photo,102,24,5,131
86680728811,"Hillary Clinton and her Democratic allies have invested at least $41 million in commercials in crucial states such as Ohio, Florida and Nevada over the next six weeks—while Donald J. Trump has made few preparations for contending with that sort of well-oiled political machine: http://abcn.ws/21tZqby",2016-06-19 19:13:55,link,53,80,44,177
5281959998,"""Missing the Olympics? For sure, that's a reasonable punishment for the crime.""",2016-06-17 02:55:00,link,195,53,22,270
112638779551,Head coach Ron Rivera reportedly has agreed to an extension with the Carolina Panthers.,2016-06-16 15:26:34,link,193,16,23,232
95926963131,The 28-year-old soccer player is officially courting 22-year-old Jinger Duggar.,2016-06-20 13:58:03,link,161,52,44,257
10513336322,"Off-grid communities such as those in sub-Saharan Africa can pay thousands of times as much as the rest of us for their energy. Designer Jim Reeves has developed a simple, low-cost gear-train and generator that uses a descending weight to power a perpetual light source. Children can do their homework and study, families and friends can eat together and interact after dark adding new dimensions and possibilities to their lives",2016-06-21 12:40:00,video,60,45,32,137
13652355666,"It's been exactly one year since Dylann Roof allegedly shot and killed nine black parishioners inside a church in Charleston, S.C.

More things to know: http://usat.ly/1W3cTHZ",2016-06-17 06:12:04,photo,100,75,20,195
7245371700,Keke Palmer is taking over the Internet.,2016-06-15 16:52:50,link,162,33,43,238
18807449704,And we have the proof.,2016-06-23 05:47:56,link,56,94,2,152
10513336322,"""Hot and smoky, almost irreverent. Imagine WC Fields extinguishing a cigar on your tongue.""",2016-06-22 03:00:01,link,18,88,50,156
7245371700,"Let's try to answer the age-old question ""Does size matter?"" with Laci Green on ""Pants Off"".",2016-06-19 21:00:00,video,1,80,12,93
5281959998,Little fritters all fried up.,2016-06-15 22:55:00,link,1,78,36,115
52150999700,Wow–Diane Keaton + a glass of wine = HILARIOUS. 😂❤️,2016-06-17 09:29:00,link,99,21,3,123
95926963131,"Sinéad O'Connor is said to be in Chicago, but no one is sure of her whereabouts.",2016-06-23 23:15:24,link,37,50,33,120
10513336322,"""He has just ruined it for us here. He has hemmed us in. Mr Trump likes his walls.""",2016-06-23 13:00:00,link,12,54,39,105
10606591490,"From Kim Kardashian West's nude selfie, to that celebrity-packed Oscars photo with Ellen DeGeneres.",2016-06-21 18:01:16,link,3,90,3,96
52150999700,"Baby Dory is the cutest thing you'll see all day, Finding Nemo fans! 😍",2016-06-20 15:05:22,link,151,19,44,214
10606591490,Eerie.,2016-06-21 00:00:36,link,62,93,8,163
95926963131,What began as a celebration of her high school graduation turned into a tragic night out.,2016-06-16 21:44:04,link,92,5,16,113
7245371700,Maybe Zayn will rethink that studio time w/Tyler the Creator?,2016-06-23 00:02:20,link,184,18,50,252
95926963131,The new Real Housewives of Orange County cast member has been pre-warned about Vicki Gunvalson.,2016-06-21 03:00:17,link,172,59,48,279
52150999700,Whoa–Get ready to see That '70s Show (Official)'s Wilmer Valderrama like we've never seen him before! 😱🔥,2016-06-16 17:32:58,link,77,81,30,188
95926963131,One sex crime survivor is speaking out in a heartfelt letter to the Stanford sexual assault victim.,2016-06-23 18:18:06,link,116,63,17,196
95926963131,Allow us to re-educate you on the beauty that is Jeremy Meeks. (via PeopleStyle),2016-06-15 07:44:03,link,128,40,6,174
5281959998,"CNN's Anderson Cooper writes about his father, who passed away when he was just 10: ""If I could see my father just once more, sit down and talk with him, look into his crystal blue eyes, feel the safety of his arms around me, I would give anything for that.""",2016-06-19 10:55:00,link,80,79,5,164
95926963131,Donald J. Trump' s inflammatory response to the Orlando massacre has him facing an unusual alliance: Barack Obama  and Republicans.,2016-06-15 12:06:36,link,33,7,42,82
112638779551,"Boston Red Sox 1B Hanley Ramirez had plenty of reasons to smile Wednesday, and so did a few fans near the on-deck circle at Fenway Park.",2016-06-16 09:14:24,link,164,14,17,195
10513336322,"Hundreds of people have been queuing up to get a tattoo commemorating the 49 killed during last Sunday's mass shooting at an LGBT club in Orlando, Florida.",2016-06-19 08:40:00,video,44,87,43,174
95926963131,Cats have taken over the Internet—and now the hospitality industry. (via PEOPLE Pets),2016-06-18 07:00:42,link,125,23,14,162
112638779551,UFC paid tribute to Kimbo Slice Saturday,2016-06-19 14:53:06,link,104,89,24,217
10513336322,"""Sir Philip Green is swapping the luxury of the Monto Carlo yacht club for the relative austerity of parliament's Portcullis House at 9:15am today, as MPs continue to probe the collapse of the BHS retail chain. And it should be an absolute belter of a session.""

Follow it live with us.",2016-06-15 03:00:00,link,45,11,10,66
25902406772,"LeBron James returned on a mission. 

Mission Accomplished.",2016-06-19 22:22:43,photo,15,18,27,60
13652355666,BREAKING: The second recovered voice recorder could finally unlock the mystery to what happened to doomed EgyptAir Flight 804.,2016-06-17 05:44:25,link,55,79,29,163
10606591490,Game of Thrones fans knew it was coming.,2016-06-20 07:30:25,link,200,2,14,216
18807449704,"One 'Rogue One' character is getting all the attention, Star Wars fans.",2016-06-22 20:03:07,link,139,21,39,199
10513336322,"""If we are going to drug test people to reduce the deficit, let's start on the other end of the income spectrum.""",2016-06-16 12:40:00,link,38,89,13,140
112638779551,"John Cena is an overachiever 

Kristen Balboni for @TheBuzzer",2016-06-19 17:20:40,video,125,19,40,184
10606591490,Whoa.,2016-06-18 23:30:20,link,191,34,32,257
13652355666,"BREAKING: Russia's track and field athletes will not be able to compete in the Rio Olympics, according to multiple news reports.",2016-06-17 10:21:45,link,143,55,47,245
95926963131,"In order to prepare Finding Dory, this 12-year-old got a pretty cool homework assignment.",2016-06-19 09:01:17,link,72,96,22,190
13652355666,There's something undeniably appealing about a beautiful waterfront.,2016-06-20 21:53:00,link,152,56,28,236
25902406772,Michael Jordan had a legendary performance on this day 23 years ago.,2016-06-16 12:54:35,link,149,3,13,165
112638779551,"Football still is in the genes of the family of the late Darryl Stingley,",2016-06-18 08:20:12,link,187,1,26,214
25902406772,Bill Belichick will always be.. Bill Belichick.,2016-06-23 19:50:39,link,172,88,21,281
112638779551,"Some only need one name. The legend of Arnie, as told by Jack.

The 2016 U.S. Open Championship is welcomed back to Western Pennsylvania.",2016-06-16 18:33:00,video,179,28,14,221
52150999700,Who's the merriest man of them all?,2016-06-16 03:41:00,link,162,32,43,237
13652355666,Mateen is buried in the Muslim Cemetery of South Florida.,2016-06-22 20:50:00,link,51,71,23,145
52150999700,The brand new character portraits for Miss Peregrine's Home for Peculiar Children are MAGICAL. 😍✨,2016-06-17 10:21:00,link,115,92,38,245
86680728811,Goodnight moon: Strawberry Moon as seen from NYC on the first night of summer.,2016-06-20 21:20:52,photo,54,75,1,130
86680728811,Congressman Steve King's amendment would prevent the U.S. Department of the Treasury from redesigning currency - and keep civil rights activist Harriet Tubman off the $20 bill.,2016-06-22 06:28:07,link,32,57,10,99
7245371700,"Whoa, I'm definitely into this new feel.",2016-06-22 10:32:50,link,3,74,30,107
10606591490,The disclosure makes it unclear what other emails may have been deleted.,2016-06-23 21:00:04,link,159,18,24,201
86680728811,"Facebook CEO Mark Zuckerberg covers his laptop camera and microphone with tape. While the move may strike some as paranoid, the practice is recommended by security experts as a defense against hackers.",2016-06-22 22:25:22,link,51,53,20,124
86680728811,Brenda Lee Marquez-McCool was dancing with her son at Pulse nightclub when shots rang out over the blaring music.,2016-06-21 05:30:26,link,156,11,8,175
10606591490,Answer this one question to see.,2016-06-20 07:00:15,link,139,22,42,203
10513336322,"""People going to ISIS don't have anything in their lives. Graffiti showed me you can succeed even if you have nothing. Art has changed countries and empires, and I chose graffiti because it's my lifestyle.""",2016-06-21 06:40:00,link,109,33,20,162
52150999700,The Independence Day director is NOT a fan of the hugely popular Marvel films.,2016-06-20 18:23:00,link,9,98,14,121
112638779551,"U.S. Army veteran Jonathan Lopez works hard to empower other veterans to never give up. 

Kristen Balboni for @TheBuzzer",2016-06-17 14:42:00,video,80,74,25,179
112638779551,"Tim Lynch spent his childhood hunting down the likes of Miguel Cabrera and Lorenzo Cain for autographs. Now, he's a New York Yankees prospect.",2016-06-16 06:22:56,link,34,73,8,115
10606591490,"When life gives Beyoncé lemons, she crowns herself with them.",2016-06-21 19:00:57,link,149,20,12,181
5281959998,"""It would be nice to have some help from the party,"" Donald J. Trump said on NBC's Today Show.",2016-06-21 09:25:00,link,91,20,26,137
10513336322,"Joe Wicks: ""A hundred thousand people have done my plan, but my goal is millions and millions. Instead of Weight Watchers and Slimming World and Juice Plus, they're all going to come to me.""",2016-06-18 09:40:01,link,164,18,34,216
13652355666,The cause? A combo of man-made global warming and the El Niño.,2016-06-16 13:07:26,link,26,95,41,162
18807449704,Purr-fection.,2016-06-19 01:00:00,link,172,7,17,196
112638779551,These sisters will make their #NASCAR XFINITY Series debut this weekend at Iowa Speedway.,2016-06-15 13:48:07,link,91,80,31,202
18807449704,UH-OH.,2016-06-22 18:24:18,link,110,73,10,193
7245371700,Lil Wayne reflects on his recent health scare.,2016-06-23 15:40:11,link,176,28,40,244
13652355666,Because dads.,2016-06-20 14:16:00,link,81,21,17,119
25902406772,"No, the Houston Astros were NOT hacked.",2016-06-17 19:51:54,link,190,60,28,278
10606591490,"Road trip, anyone?",2016-06-18 01:00:20,link,66,86,24,176
10606591490,He might think twice the next time he drinks and tips.,2016-06-15 21:00:13,link,30,10,47,87
95926963131,The conversation about gator safety at Walt Disney World has become a hot topic.,2016-06-20 07:44:07,link,60,42,28,130
10606591490,5. Contract negotiation.,2016-06-18 06:30:06,link,112,53,13,178
86680728811,"Congressman Chaka Fattah offered his resignation from the House effective Oct. 3 following his conviction on charges of racketeering, fraud and money laundering, but House Speaker Paul Ryan is calling on Fattah to resign immediately.",2016-06-22 20:24:52,link,52,62,34,148
18807449704,Watch this incredible concert Greenpeace International staged on ice in the middle of the Arctic Ocean.,2016-06-22 08:53:21,video,114,80,13,207
86680728811,"ESA - European Space Agency astronaut Tim Peake shares stunning image from space before beginning journey back to Earth: ""What an incredible journey it has been."" http://abcn.ws/1UeczBi",2016-06-17 16:56:52,link,137,37,5,179
10606591490,3. They are never wrong.,2016-06-15 08:30:31,link,53,57,44,154
95926963131,"Yes, this actually happened—and it was glorious. (via PEOPLE Pets)",2016-06-24 01:00:16,link,3,89,40,132
10513336322,Shady internet lenders in China are reportedly coercing female college students to provide nude pictures of themselves as collateral – a loan-for-porn scheme that has prompted anger on the country's internet.,2016-06-15 10:20:00,link,8,16,41,65
52150999700,"After 13 years, Ellen DeGeneres' wish of a Finding Nemo sequel is FINALLY here. 🙌🐠❤️",2016-06-16 23:35:00,link,10,3,40,53
52150999700,Woody Allen's new film just added some Titanic star power. 🌟,2016-06-22 00:20:00,link,3,13,38,54
10606591490,5. Don't hold financial leverage over your daughter's head.,2016-06-19 07:01:08,link,30,6,18,54
13652355666,An emotional LeBron James and his kids take the podium after winning Cleveland's first major-league title in 52 years,2016-06-19 22:34:59,video,70,93,48,211
52150999700,"""Is it too late now to find Dory?"" - Justin Bieber 😂",2016-06-17 08:26:00,link,52,18,31,101
7245371700,Voting for the 2016 Fandom Awards is now open: http://fandomawards.mtv.com,2016-06-22 09:31:52,video,136,81,4,221
13652355666,Cradle that roll for just $8.99.,2016-06-17 20:33:00,link,13,8,32,53
7245371700,Asaf is coming clean about last night's Are You The One? drama!,2016-06-21 14:26:28,video,179,75,22,276
13652355666,"""Yowza""",2016-06-15 20:38:01,link,54,44,36,134
5281959998,"While you're watching Northern Ireland on the field during UEFA EURO 2016, see in real time its chances of advancing to the next round.",2016-06-21 10:20:00,link,32,11,16,59
25902406772,Rory McIlroy with the BEAUTY.,2016-06-15 10:04:38,link,106,23,27,156
75932763901,"Her ex makes $126,000 a year while she's ""basically broke!"" See which star is desperate for spousal support (via Closer Weekly) —> http://bit.ly/1OD857T",2016-06-24 04:00:00,photo,199,43,50,292
10606591490,They're asking for a ransom of almost $13 million.,2016-06-16 03:30:20,link,90,94,16,200
75932763901,"Welcome to the world, Skyla! Find out who gave birth to this beautiful baby girl! —> http://bit.ly/1ZRi90k",2016-06-15 12:00:00,photo,5,82,18,105
10513336322,"""A haunting, captivating story of the unique relationship between a gorilla and her human mother.""",2016-06-15 14:00:00,link,157,65,16,238
7245371700,"Laugh all you want, but this documentary seems to have a lot of terrifying twists and turns...",2016-06-19 15:55:50,link,40,75,18,133
86680728811,"""You can't capture this on an iPad, or a flatscreen, or even an oil painting,"" President Obama says. ""You've got to come in and breathe it in here yourself."" http://abcn.ws/1UIgZQL",2016-06-19 18:05:14,link,123,8,33,164
18807449704,"""My great ambition is to be in a Fast & Furious movie.""",2016-06-15 22:15:01,link,116,68,50,234
95926963131,Stephanie Seymour is apologizing to Kendall Jenner and Gigi Hadid after she made harsh comments about the supermodels to Vanity Fair.,2016-06-20 17:40:00,video,48,95,20,163
95926963131,Would you lie and steal for an avocado? That's exactly what these people are doing. (via People Great Ideas),2016-06-16 05:00:16,link,10,7,31,48
10513336322,"""You dress kind of strange, don't you?"" said Nixon. Elvis replied: ""You have your show and I have mine"".",2016-06-19 12:40:00,link,180,71,13,264
112638779551,The Ohio State Buckeyes are using Tim Tebow -- the guy that beat them in the 2007 national championship -- to help in recruiting.,2016-06-15 11:07:23,link,176,30,16,222
86680728811,"JUST IN: DOJ and FBI release full transcript from Orlando shooter's 911 call to provide the ""highest level of transparency."" abcn.ws/28It1Ld",2016-06-20 14:09:57,link,66,75,1,142
52150999700,Game of Thrones' biggest episode yet will determine the fate of Jon and Sansa.,2016-06-19 12:07:00,link,116,70,26,212
112638779551,Cleveland Cavaliers fans are taunting the hell out of Kevin Love before Game 6. Yikes.,2016-06-16 18:13:43,link,45,94,13,152
7245371700,The genesis of pop music loans itself heavily if not entirely to the gay club scene.,2016-06-17 18:25:39,link,152,75,20,247
95926963131,The suspect allegedly told police he fought with his father over not standing guard for him while he was taking a shower. (via People True Crime),2016-06-20 22:48:03,link,144,77,26,247
95926963131,Katherine Heigl is expecting her third child with musician Josh Kelley! (via People Babies),2016-06-23 07:40:04,link,31,48,28,107
10606591490,"TIME's new cover: Orlando, June 12, 2016. Why did they die?
http://ti.me/1Xrd1So",2016-06-16 06:30:43,video,54,34,14,102
13652355666,"From the death of a jaguar that was part of the Olympic torch ceremony, to a collapsed bike path that killed two people...",2016-06-22 21:20:00,link,103,19,48,170
10513336322,Croissant the line.,2016-06-22 13:00:00,link,66,51,13,130
10606591490,"The pilot heard ""meows"" coming from inside his BMW.",2016-06-15 11:00:33,link,20,93,7,120
10606591490,And 90% lose their wealth by the third.,2016-06-19 13:00:52,link,115,50,35,200
13652355666,#TrumpSoPoor: Twitter mercilessly mocks Donald J. Trump's money woes. http://usat.ly/28KQLl6,2016-06-21 15:30:00,video,85,47,34,166
95926963131,"Thanks to her mom's strict policy on missing school, this graduate really has something to celebrate!",2016-06-17 01:00:28,link,117,60,34,211
5281959998,"17 great ideas for what to watch this weekend, from the NYT Watching team.",2016-06-18 20:25:00,link,115,48,26,189
95926963131,"After coming out of a dark place, Charlie Sheen has finally found his purpose.",2016-06-18 10:41:16,link,50,94,33,177
10606591490,Bring a collapsible laundry bag with you.,2016-06-19 04:00:25,link,200,13,41,254
25902406772,Would you pay this much for courtside Game 7 tickets?,2016-06-18 21:16:31,video,54,76,5,135
10513336322,"LeBron James: ""I'm happy to be a part of history. I'm home. I'm home ... I'm at a loss for words. This is unbelievable.""",2016-06-20 01:31:22,link,157,28,28,213
25902406772,Magnuson enters the 2016 season as one of the top-10 senior offensive tackles in the country.,2016-06-17 12:44:05,link,168,2,36,206
10513336322,"""By now, you probably think you know where you are with steak. Over the past decade, we've swapped fillet for rib-eye, flirted with grain-fed US beef and la-di-dah wagyu, before, it seemed, a broad consensus formed around the idea that some of the best steak you can eat comes from properly dry-aged, grass-fed British rare-breeds, such as Longhorn... But that was before the old Basque cows reared their delicious bovine heads.""",2016-06-20 07:40:00,link,11,33,20,64
52150999700,The new Ghostbusters stars weigh in on who'd win in a fight with the Avengers: http://share.ew.com/dTeIf8C 👻 👊🏼,2016-06-16 17:03:00,video,159,9,29,197
10513336322,Are vitamin and mineral supplements really good for us?,2016-06-15 05:40:00,link,180,23,4,207
112638779551,"Ken Griffey Jr. and Ichiro Suzuki had a great relationship with the Seattle Mariners, which included a lot of tickling.",2016-06-17 07:37:18,link,103,94,2,199
86680728811,The effort to come up with a way to manage bison at Grand Canyon National Park has taken a turn back in time — thousands of years — to determine the massive animals' roots.,2016-06-18 05:03:03,link,10,45,37,92
25902406772,Those were some scary scenes on the field and in the stands.,2016-06-17 13:30:22,link,175,4,7,186
25902406772,Nick Chubb has his sights set on the Georgia Football opener.,2016-06-20 22:31:06,link,180,70,29,279
13652355666,"""My health and my family's health comes before everything else.""",2016-06-22 08:41:00,link,163,50,29,242
95926963131,Caitlyn Jenner got a few sweet wishes from daughters Kendall Jenner and Kylie Jenner.,2016-06-19 14:20:06,link,143,93,35,271
18807449704,Glorious. 😆 😆,2016-06-22 17:00:41,link,65,98,25,188
7245371700,Can you believe that was almost 13 years ago?,2016-06-15 15:17:59,link,192,51,7,250
95926963131,A lot has happened since the Teen Mom 2 stars have wrapped filming for this season.,2016-06-20 23:10:05,link,111,96,29,236
18807449704,Happy wrapping!,2016-06-16 19:51:50,link,83,47,40,170
7245371700,Not only that. There's a great card here that Taylor Swift should give to Selena Gomez.,2016-06-17 07:18:27,link,97,4,30,131
112638779551,Rory McIlroy says the risk is too great for him to take part in the Olympic games.,2016-06-22 06:36:56,link,18,24,5,47
5281959998,"If you're watching ""UnREAL,"" what do you think of this season so far?",2016-06-21 17:40:00,link,13,1,40,54
112638779551,"Two soccer stars teamed up to help 22 children receive life-saving surgeries.

Nicole Dabeau for @TheBuzzer.",2016-06-23 19:53:20,video,194,26,27,247
52150999700,Joan Rivers' spirit lives on all around the world. ❤️,2016-06-16 13:19:00,link,104,88,15,207
10513336322,"""When anyone says, 'Can we have a two-woman ticket for the US presidency?' they're saying, 'We all know that the thought of two women in the highest office of power will cause a lot of people to throw up all over themselves. So let's not hurt their ickle feelings by suggesting it, 'kay?'""",2016-06-18 10:20:01,link,103,22,44,169
10606591490,"""1 in 5 hiring managers say they have asked a question in a job interview only to find out later that it was a violation of federal labor laws to ask it.""",2016-06-17 09:40:10,link,93,26,39,158
86680728811,"Doctors perform life-changing surgery on baby whose brain protruded from his head. ""How do you say thank you to someone for saving your child's life?""",2016-06-22 10:17:12,link,158,45,13,216
7245371700,He was literally the coolest dad on TV.,2016-06-22 05:34:27,link,94,59,29,182
52150999700,"Elizabeth Banks' actual role in Spider-Man was a ""consolation prize.""",2016-06-23 08:15:00,link,123,14,8,145
75932763901,"Uh oh! You won't believe which actress John Goodman admitted he'll ""never speak to again"" after they had an awkward run-in (via Closer Weekly) —> http://bit.ly/1Ld0FJy",2016-06-24 03:00:00,photo,200,39,33,272
7245371700,Ariana Grande sharing the love.,2016-06-18 12:39:04,link,200,4,32,236
10606591490,"""Since we've started this training, I'd say the incidence of trafficking has dropped dramatically.""",2016-06-20 01:30:18,link,6,56,21,83
25902406772,dang,2016-06-20 20:38:30,link,45,33,4,82
86680728811,"From his hospital bed, Orlando shooting survivor Angel Colon tells ABC News the story of an officer who he says helped him escape while the killer was engaged in a gun battle with police.",2016-06-15 16:47:26,link,117,26,41,184
5281959998,"What did you think of this week's episode of ""Game of Thrones""? (Spoilers ahead.)",2016-06-20 06:10:01,link,138,1,32,171
5281959998,"Misty Copeland returns to her role in ""Swan Lake"" on Wednesday. Will she do 32 fouettés this year?",2016-06-15 11:40:00,link,4,31,5,40
7245371700,Are Republicans starting to buy into Donald J. Trump's frighteningly flawed logic?,2016-06-23 14:48:29,link,74,41,8,123
5281959998,Guns. Gay rights. Islamic extremism. Immigration. Latinos. Orlando is more than our preferred family vacation destination. Orlando is these fractured United States. Orlando is us.,2016-06-20 20:55:00,link,80,59,12,151
75932763901,CONGRATS! Click here to find out who welcomed twin boys —> http://bit.ly/28WNcXa,2016-06-24 18:30:00,photo,7,64,18,89
10513336322,"""If the photos, and the subsequent ones of the couple getting on Taylor Swift's private jet, are true, then Tom Hiddleston is going to come under the kind of scrutiny that will test his refined unflappability to the very limit.""",2016-06-19 03:40:00,link,115,73,30,218
13652355666,Frank Freshwaters is free. Again.,2016-06-16 08:03:00,link,153,25,18,196
25902406772,"Dustin Johnson, Jason Day, Sergio Garcia and Lee Westwood will all take aim at the Irishman on Sunday afternoon.",2016-06-18 21:34:19,link,24,25,11,60
25902406772,Andrew Bogut will not return to the finals and questions JR Smith's play.,2016-06-16 15:55:36,link,97,1,3,101
25902406772,The Dallas Cowboys has had some good years and some bad years.,2016-06-17 08:16:25,link,67,54,45,166
18807449704,"""I opened the gym because I wanted to help tomboys and trans men to have nice bodies.""",2016-06-20 21:56:07,link,150,84,26,260
86680728811,"Former ISIS captive to U.S. lawmakers: ""No place is safe for anyone. Orlando will be repeated if the world doesn't put an end to such terrorism. There is no sanctuary.""",2016-06-22 20:46:10,link,52,68,35,155
5281959998,There are only a few doctors left in Alabama who provide abortions. Yashica Robinson is one of them. (via The New York Times Opinion Section),2016-06-16 22:55:00,link,55,77,8,140
112638779551,Is this a sign that Stephen Curry is locked in for Game 7? The Golden State Warriors better hope so.,2016-06-19 18:19:56,link,27,50,45,122
7245371700,Vince Staples is giving back to his community.,2016-06-15 19:45:18,link,88,86,43,217
86680728811,Google improves its symptoms-searching capabilities for the millions of people turning to the internet to diagnose their health conditions.,2016-06-22 22:47:18,link,129,3,20,152
86680728811,"Family set to inherit gun stockpile worth millions plans to destroy the weapons 'to send a message.' ""They want these instruments of death to be destroyed. They don't want these weapons out on the street.""",2016-06-22 16:37:22,link,90,76,47,213
95926963131,"She may be small, but Princess Charlotte's fashion influence looms large! (via People Royals)",2016-06-18 14:40:09,link,188,8,27,223
18807449704,"Record-breaking heat fuels West Coast wildfires, forcing hundreds to evacuate.",2016-06-22 21:20:00,video,192,89,6,287
10606591490,Bernie Sanders isn't giving up.,2016-06-16 20:30:10,link,200,24,9,233
10606591490,Fans are spellbound by Harry Potter and the Cursed Child. http://ti.me/1UaR5aG,2016-06-18 09:01:04,video,67,75,40,182
7245371700,Glad we got clarification on that one.,2016-06-20 13:35:20,link,47,10,7,64
95926963131,Mila Kunis and her bump stepped out for lunch with friends. (via People Babies),2016-06-22 11:26:05,link,3,12,43,58
112638779551,That's one way to catch a home run.,2016-06-20 07:47:12,link,178,9,28,215
52150999700,Former Two and a Half Men star Charlie Sheen is getting VERY candid when it comes to his mistakes.,2016-06-21 08:36:09,link,70,71,37,178
112638779551,This had to hurt.,2016-06-23 09:59:34,link,40,52,41,133
10606591490,Are you making this mistake?,2016-06-18 12:01:03,link,9,97,29,135
13652355666,Live with Gary Johnson Libertarian candidate for President,2016-06-16 09:38:12,video,177,91,7,275
112638779551,Ben Simmons is preparing for life in Philadelphia,2016-06-22 09:12:35,link,155,20,5,180
95926963131,The frantic search for the 2-year-old boy has come to a tragic end.,2016-06-15 15:39:10,link,183,66,47,296
25902406772,Uhhhh....,2016-06-17 13:31:56,link,107,59,30,196
52150999700,Kelly Clarkson is off vocal rest and preparing for a major reveal!,2016-06-20 13:39:00,link,128,5,10,143
5281959998,Hillary Clinton gave this message: I alone am the candidate who knows how to turn those underlying frustrations into actual policies that might make things better.,2016-06-22 20:55:00,link,64,60,9,133
86680728811,"If you bought a ticket through Ticketmaster between late 1999 and early 2013, you could be eligible for free tickets to a number of events.",2016-06-20 13:24:03,link,140,12,7,159
25902406772,"Years after ""The Fumble,"" Earnest Byner is thrilled to see Cleveland win a title.",2016-06-21 20:22:32,link,181,7,46,234
5281959998,"""If they had not been three blocks from the hospital, they might not have made it to the hospital,"" one surgeon said.",2016-06-15 10:25:00,link,172,30,33,235
86680728811,"""I wouldn't call it defiance. I wouldn't call it perseverance. I would call it just living your life and not being scared to live your life."" http://abcn.ws/1UIgoOM",2016-06-19 12:32:37,link,121,4,25,150
86680728811,Hillary Clinton earned 47% support in new poll vs. Donald J. Trump at 39%.,2016-06-21 13:27:52,link,70,43,23,136
10606591490,2. Mark Cuban: Learn to manage your credit cards.,2016-06-23 22:30:11,link,97,60,43,200
10513336322,"Best known for his role as Chekov in the Star Trek reboot, actor Anton Yelchin has died at the age of 27.",2016-06-19 15:47:01,link,33,96,16,145
7245371700,"""The focus should be on the music and not my sexuality.""",2016-06-24 01:18:15,link,132,4,5,141
52150999700,The iconic board game Monopoly is heading to the stage!,2016-06-20 21:55:00,link,10,16,13,39
10606591490,A look at all of the insane things that have happened in Game of Thrones' 9th episodes.,2016-06-17 13:30:17,link,191,69,30,290
5281959998,"Britain decides today whether to leave or stay in the European Union. We're in Tunbridge Wells, a town south of London, with Alison Smale of The New York Times, a Briton who has spent decades living on the European continent. Let us know what you think in the comments.",2016-06-23 08:14:38,video,67,71,29,167
86680728811,"Florida gun store owner says the Orlando nightclub shooter tried to buy body armor and bulk ammunition from his store just a few weeks before the shooting, but his staff turned him away: ""We knew by the questions he was asking he was suspicious."" http://abcn.ws/1XrxnLe",2016-06-16 10:09:44,link,57,2,34,93
95926963131,Amy Schumer just landed another major fashion magazine cover. (via PeopleStyle),2016-06-16 11:47:08,link,149,7,48,204
112638779551,"Is soccer in the U.S. ""a sport for the upper class""? Today on Speak For Yourself, Alexi Lalas responds to Jason Whitlock's comments.

Watch at 6pm ET on FS1!",2016-06-23 15:00:38,video,99,30,39,168
13652355666,"And, it's not the first time.",2016-06-17 22:27:00,link,49,73,33,155
112638779551,Cleveland Indians catcher Yan Gomes isn't taking any chances after taking a foul ball in the worst possible spot.,2016-06-15 20:16:48,link,121,60,28,209
13652355666,"Every attendee can appreciate connectivity with T-Mobile's 4G LTE network and Wi-Fi, and charging stations abound.",2016-06-18 09:08:00,link,113,99,1,213
7245371700,Adding these acoustic covers to my summer playlist.,2016-06-20 18:05:01,link,19,9,42,70
95926963131,YouTube star Mindy McKnight points out that all bodies and babies are different—and shouldn't be judged. (via People Babies),2016-06-20 06:00:23,link,167,88,50,305
52150999700,Billy Joel's powerful performance will give you chills.,2016-06-18 17:11:00,link,150,27,44,221
10606591490,"He called nightclub patrons ""3rd world miscreants and ghetto thugs""",2016-06-18 10:30:20,link,133,17,44,194
95926963131,"America's Got Talent host Nick Cannon sent a message to the ""haters"" about his relationship with ex Mariah Carey. (via People Video)",2016-06-21 13:25:57,video,109,95,31,235
5281959998,"He was in prison for plotting an acid attack on a rival. Now Pavel V. Dmitrichenko, a dancer, hopes to return to the stage.",2016-06-22 04:55:01,link,60,57,33,150
112638779551,#OutkickTheShow with Clay Travis coming up LIVE from the U.S. Open Championship tonight.,2016-06-18 18:42:20,video,186,5,4,195
7245371700,"""Among all the D.C. shows, it hews closest to our political universe, with Hillary Clinton and especially Donald Trump appearing in the background, spouting carnivalesque nonsense.""

Oh and there are extraterrestrial insects crawl into people's brains and take over their personalities.",2016-06-18 09:17:17,link,66,60,46,172
7245371700,Team Tormund or team Lannister?,2016-06-18 19:04:04,link,68,54,47,169
52150999700,This is BIG news for Disney Pixar fans. 😀,2016-06-18 17:31:00,link,168,74,12,254
13652355666,NASA's website already has a countdown.,2016-06-24 03:30:00,link,103,32,36,171
112638779551,Making the U.S. Olympic team as a long jumper could put Marquise Goodwin's roster spot in jeopardy.,2016-06-21 13:20:59,link,40,2,34,76
5281959998,LeBron James could win more NBA championships. But whatever comes next won't be as meaningful.,2016-06-22 13:25:00,link,46,47,20,113
25902406772,Eric Bledsoe may be on the move.,2016-06-22 14:30:55,link,177,66,33,276
112638779551,Golden State Warriors center Andrew Bogut is not convinced his collision with Cleveland Cavaliers guard J.R. Smith was a basketball play.,2016-06-16 16:44:49,link,81,25,28,134
10513336322,"As Britain's voters go to the polls to make one of the biggest political decisions in the country's recent history, Tom Clark runs through all you need to know on the hours ahead.",2016-06-23 01:20:00,video,123,27,37,187
10606591490,Experts reveal common bad habits you should avoid.,2016-06-18 21:00:36,link,176,16,8,200
5281959998,For when you don't want to turn on your oven.,2016-06-21 13:55:00,link,60,61,8,129
10513336322,"""It is time to stop making excuses and take some responsibility.""",2016-06-16 07:40:01,link,94,96,33,223
112638779551,"After losing the NBA Finals, Draymond Green found LeBron James to share a message with him.",2016-06-19 23:13:55,link,118,48,34,200
52150999700,There were some HUGE twists on the season premiere of Big Brother. 😱,2016-06-22 23:56:11,link,88,28,29,145
86680728811,"Donald J. Trump says we should ""start thinking about"" profiling in order to prevent events like the mass shooting in Orlando: ""I hate the concept of profiling. But we have to start using common sense and we have to use, you know, we have to use our heads.""  http://abcn.ws/21tMjaq",2016-06-19 13:23:11,link,23,64,28,115
13652355666,An argument the day before Father's Day turned deadly.,2016-06-19 22:40:00,link,161,94,7,262
95926963131,"People is LIVE with Best Friends Animal Society - New York City to try the newest cat grooming tool, the Licki Brush, which allows you to lick your own cat as their mother would. Tune in now to see how the new brush works and to meet a few adoptable cats!",2016-06-20 14:05:52,video,115,46,43,204
86680728811,"""He's got his Father's Day gift,"" Kristen said of her husband. ""Just the experience alone, for him to be the first one to hold him has been amazing for him."" http://abcn.ws/1UCQ5xB",2016-06-18 17:10:39,link,183,28,26,237
13652355666,"The FBI released partial transcripts of three conversations negotiators had with Orlando nightclub shooter, Omar Mateen. http://usat.ly/28IQNZW",2016-06-20 16:55:28,video,156,6,11,173
112638779551,"Everyone says former Duke Basketball star Brandon Ingram plays like a ""young Kevin Durant.""

But you won't believe who Ingram says he models his game after...",2016-06-15 13:04:05,link,49,75,17,141
52150999700,America's Got Talent loves surprises...and pizza! 😯,2016-06-15 09:17:58,link,134,41,21,196
112638779551,Look back to Jordan Spieth's 2nd shot to 18 last year & discussing today's rain delay at the U.S. Open Championship. #LookAgain,2016-06-16 12:17:02,video,97,94,6,197
10606591490,"The Sheriff said the boy's body was found ""completely intact.""",2016-06-15 17:00:05,link,8,80,49,137
13652355666,"""The government's response appears to be insufficient or politicized, so people are resorting to robbery.""",2016-06-16 18:50:00,link,68,78,8,154
10606591490,"Kevin Hart: ""James Corden thinks I look like a kid. Well, I might be small, but my bank account's big.""",2016-06-16 10:30:11,link,123,65,18,206
5281959998,Breaking News: The 2015 Jeep Grand Cherokee that killed the actor Anton Yelchin was a model that had been recalled.,2016-06-20 17:12:11,link,166,87,9,262
112638779551,"""A shot poorly played should be a shot irrevocably lost."" #Oakmont is the real deal, y'all. Find out what makes the U.S. Open course the toughest in the world. #USOpen",2016-06-15 19:35:07,link,106,93,19,218
10606591490,GOP agrees to vote on gun control following a 15-hour Senate filibuster by Democrats. http://ti.me/1ZU45Dh,2016-06-16 11:15:01,video,89,18,21,128
112638779551,"Golden State Warriors head coach Steve Kerr on Stephen Curry's ejection: ""I'm happy he threw his mouth piece, he should be upset."" #NBAFinals",2016-06-16 23:30:49,video,74,80,32,186
112638779551,"Can't watch Speak For Yourself, give it a listen!",2016-06-15 08:42:11,link,101,5,4,110
52150999700,Jennifer Aniston has a special delivery on the way in Storks Movie! 👶🏼,2016-06-15 13:03:08,link,23,78,13,114
86680728811,"Orlando shooter Omar Mateen sent text messages to his wife during the attack on Pulse nightclub, sources briefed on the investigation told ABC News.",2016-06-16 23:49:33,link,66,66,46,178
5281959998,"""White Trash"" — about crackers and squatters, rednecks and hillbillies — will have you squirming in your chair.",2016-06-21 20:10:00,link,126,89,25,240
10606591490,Great advice for recent college grads.,2016-06-20 06:00:57,link,15,75,6,96
7245371700,"""That's why you should never devalue another human.""",2016-06-16 02:31:30,link,123,19,32,174
112638779551,"We'll give Stephen Curry credit for not being intimidated by LeBron James, but this is starting to get ridiculous.",2016-06-19 20:16:01,link,117,76,22,215
10606591490,It tops a survey of 209 cities.,2016-06-22 07:30:25,link,137,97,25,259
10606591490,"""Very glad people can differentiate me from the character.""",2016-06-21 12:30:16,link,188,78,42,308
25902406772,Los Angeles Dodgers makin' moves. Here's why.,2016-06-19 20:48:27,link,129,19,28,176
5281959998,"""There are kids I don't recruit because I see their social media,"" one coach said.",2016-06-21 08:25:00,link,25,78,36,139
86680728811,"NEW: Egyptian officials confirm to ABC News that wreckage of EGYPTAIR flight MS804 has been located, nearly one month after the plane disappeared from radar: http://abcn.ws/1rqBNUX",2016-06-15 15:43:59,link,196,14,21,231
5281959998,"When should you give up on a marriage for good? That's up for debate.

Read on in The New York Times Opinion Section.",2016-06-21 15:25:00,link,189,93,26,308
7245371700,Two Libertarians walk into a town hall...,2016-06-23 13:33:06,link,118,80,8,206
10606591490,"""I thought, 'I'm gonna try and do a little baby CPR real quick, see if I can get some air in this kid.'""",2016-06-16 14:00:28,link,124,30,18,172
7245371700,"Aww, it's hard to spread your wings in this big, big world.",2016-06-15 08:34:20,link,146,75,3,224
10513336322,The Brexit debate is now being conducted on the river Thames.,2016-06-15 07:00:01,link,103,96,29,228
10513336322,"""The demographic differences are stark, but the attitudinal differences are greater still.""",2016-06-23 20:00:01,link,179,60,49,288
5281959998,Paul Ryan finally presented the GOP's substitute for a repealed health law.,2016-06-22 19:56:03,link,188,24,15,227
112638779551,#NASCAR's Kurt Busch and the Lithuanian national basketball team don't see eye-to-eye (literally).,2016-06-16 15:15:05,link,103,73,19,195
10606591490,Punching things does make them feel better.,2016-06-18 17:30:07,link,173,80,25,278
13652355666,Prepare to buy everything on your summer reading list.,2016-06-22 10:10:00,link,37,41,14,92
95926963131,The answer is actually quite surprising. (via PEOPLE Pets),2016-06-16 07:00:22,link,142,61,25,228
25902406772,It's a fun time in the NHL.,2016-06-23 11:50:55,link,80,90,9,179
52150999700,Hint: it has to do with a disappointing wedding gift from Donald J. Trump. 😂,2016-06-17 17:04:00,link,199,23,10,232
86680728811,Hottest May on record becomes 13th consecutive month to break global temperature records http://abcn.ws/1UVS3rz,2016-06-19 10:51:45,link,7,7,11,25
18807449704,"""Back then human trafficking never crossed our minds. But that has changed.""",2016-06-20 03:00:00,link,183,21,40,244
7245371700,"In honor of Pride Month, this is something definitely to remember. 

More #NoIDRequired here: http://on.mtv.com/28Nv926",2016-06-22 19:30:00,video,63,55,2,120
10513336322,"""There is a modern and progressive argument for leaving the EU, but it has struggled to be heard during this dispiriting campaign. It is that Europe is unable to deliver because it is wedded to backward-looking ideas.""",2016-06-21 08:00:00,link,76,92,12,180
95926963131,This dad just can't handle virtual reality! 😂,2016-06-21 14:28:03,video,22,41,25,88
75932763901,"""You've been nothing but a fake b--ch to me and talk s--t behind my back, so why would I respect you?"" OUCH! Chelsea Houska DISSED by a famous costar! And it's the last person we'd expect! –> http://bit.ly/1si6xZH",2016-06-16 03:30:00,photo,66,19,12,97
52150999700,Lin-Manuel Miranda and Phillipa Soo aren't the only ones leaving Hamilton: An American Musical.,2016-06-20 05:08:00,link,87,18,27,132
10513336322,"""A few weeks ago, I thought about buying a shed. It was the most exciting thing I did that day, because I'm a hot-rod rebel and my entire life is a thrill-a-minute joyride of unimaginable debauchery. In the end, however, I didn't buy a shed – mainly because it turns out that my tolerance for sheds is so abysmally low that I can only look at a maximum of three sheds before deciding that all sheds are stupid. However, that hasn't stopped me from being ambushed by adverts for sheds on a near-hourly basis ever since.""",2016-06-15 04:20:00,link,28,5,28,61
25902406772,Chicago Blackhawks star Patrick Kane loves Batman.,2016-06-23 11:14:03,link,12,8,16,36
52150999700,The new Survivor season will feature a BIG moment that has never happened before. 😱,2016-06-15 10:50:00,link,7,95,22,124
95926963131,This touching story of humanity offers comfort following the tragic Orlando shooting.,2016-06-17 00:00:16,link,175,44,5,224
7245371700,Your DAD Drake dresses like your actual dad.,2016-06-19 15:06:43,link,8,54,40,102
10513336322,"""I'm at the mercy of my landlord.""",2016-06-17 01:20:00,link,163,73,3,239
10513336322,The Colombian government and Farc guerrillas have declared the final day of one of the world's longest wars.,2016-06-23 14:20:01,link,141,10,42,193
52150999700,Orphan Black creators dish on the incredibly dark turn of events during the season finale.,2016-06-16 22:13:32,link,72,21,37,130
52150999700,Dwayne The Rock Johnson and Jimmy Fallon are the most hilarious prom dates ever!,2016-06-17 06:46:00,link,145,86,31,262
13652355666,DENIED.,2016-06-20 06:39:00,link,2,75,42,119
10513336322,"""Farewell, Bramble Cay melomys. We killed you and you will be remembered as the first mammalian extinction caused directly by climate change: wiped off the planet by rising seas inundating its island home in the Torres Strait, off the north coast of Australia.""",2016-06-15 06:00:00,link,177,100,19,296
75932763901,FINALLY! It's the Miley Cyrus and Liam Hemsworth news we've ALL been waiting for —> http://bit.ly/28J6tb3,2016-06-20 19:30:00,photo,68,81,29,178
95926963131,Calvin Harris is just as surprised as we all are.,2016-06-15 19:42:06,link,18,27,5,50
112638779551,New England Patriots fans would rather not talk about 2007 anymore.,2016-06-20 14:53:13,link,96,4,22,122
7245371700,"""Mother, May I Sleep With Danger? is a mess of half-articulated and half-abandoned ideologies.""",2016-06-23 06:30:31,link,140,38,20,198
5281959998,"We fact-checked Donald J. Trump's speech, in which he went after Hillary Clinton's record.",2016-06-22 11:04:36,link,45,45,16,106
25902406772,"NBA teams in need of a conductor, here's your list.",2016-06-21 14:11:07,link,200,80,39,319
75932763901,Heidi Klum's daughter Leni doesn't look like this anymore! Just WAIT until you see how grown up she looks in this new pic with her famous mom (via Closer Weekly) —> http://bit.ly/234VdfY,2016-06-21 03:00:00,photo,20,38,46,104
10606591490,Take this quiz to find out.,2016-06-21 11:00:21,link,55,99,8,162
10606591490,"""Apologies in advance if I don't ask what you did on Saturday. Really, it's not that I don't care. I just don't think that's what we came here for.""",2016-06-16 19:01:07,link,137,90,19,246
86680728811,"Sen. Chris Murphy: Gun control talk-a-thon ""helped galvanize an entire country"" http://abcn.ws/1UW8SlY #ThisWeek",2016-06-19 21:07:53,video,64,65,37,166
95926963131,Lane Graves' neighborhood is going above and beyond during this unbelievably tough time.,2016-06-18 14:20:09,link,172,54,30,256
25902406772,David Ortiz seems to get better with age.,2016-06-17 22:18:58,link,110,15,7,132
7245371700,Which of these pieces resonated with you the most?,2016-06-19 19:32:07,link,34,45,44,123
112638779551,"Danica Patrick, Tim Tebow and countless others salute their dads on Father's Day",2016-06-19 11:50:48,link,75,76,48,199
95926963131,The Rolling Stones guitarist Ronnie Wood has two more reasons to celebrate this Father's Day! (via People Babies),2016-06-19 15:40:15,link,144,88,6,238
10513336322,"""Churchill always thought of Britain as European. He was hugely engaged with European politics. He wanted Britain to be part of Europe, not separate from it. In 1940 he proposed the permanent union of Britain and France. He saw no contradiction between UK involvement in Europe and other roles in alliance with the USA or within the Anglosphere. Churchill took the lessons of war and peace seriously.""",2016-06-20 08:20:00,link,152,64,14,230
7245371700,Morrissey's refusal to be defined was his greatest subject as a songwriter.,2016-06-23 19:45:49,link,91,97,47,235
52150999700,Daniel Radcliffe and Paul Dano's relationship is actually part of a bigger Hollywood love triangle...,2016-06-23 07:30:01,link,157,100,18,275
18807449704,A visual history of fingernail fashion.,2016-06-18 02:00:00,link,171,14,44,229
95926963131,Happy Father's Day to to all the wonderful dads out there! Tag your dad in the comments below—or share a reason why your dad is wonderful! 💚🙌🏻,2016-06-19 18:40:00,link,46,36,44,126
112638779551,An increase in responsibility and emotions have made the Golden State Warriors' forward the center of attention ahead of a possible title clincher:,2016-06-16 15:03:39,link,132,58,5,195
112638779551,"This guy's golf trick shot is pretty sweet but no, he's not quite Jordan Spieth!

Andy Nesbitt for @TheBuzzer",2016-06-15 14:52:42,video,57,38,11,106
112638779551,$1 million dollars.  That's how much one famous sports bettor is putting down on Miesha Tate to win at UFC 200.,2016-06-21 09:20:25,link,145,88,19,252
25902406772,Ben Simmons worked his way to being the No. 1 pick.,2016-06-22 11:53:07,link,93,60,24,177
25902406772,Cleveland Cavaliers star Kyrie Irving is READY.,2016-06-19 15:17:30,link,5,53,42,100
10513336322,"Roger Federer: ""My parents would get so disappointed in me and upset, they would just walk away.""",2016-06-18 06:20:00,link,193,67,6,266
86680728811,"Orlando shooting suspect pledged allegiance to ISIS on Facebook the morning of the attack, FBI – Federal Bureau of Investigation officials say. http://abcn.ws/1rqmITr",2016-06-15 13:42:27,link,143,71,44,258
75932763901,Melissa McCarthy doesn't look like this anymore! See the dramatic weight loss transformation that has fans everywhere SPEECHLESS! (via Closer Weekly) —> http://bit.ly/247EyHx,2016-06-24 21:00:00,photo,155,18,18,191
52150999700,These are some serious #skwad goals.,2016-06-18 20:34:00,link,67,51,25,143
112638779551,"Fresh off her dazzling performances on Dancing with the Stars, UFC strawweight @Paige VanZant is returning to action in Vancouver",2016-06-23 13:06:55,link,82,65,19,166
18807449704,😍 😍 😍,2016-06-22 22:05:00,link,139,16,34,189
5281959998,What does your team need to do to advance to the knockout round of the 2016 UEFA EURO tournament? We have all the answers for every team.,2016-06-17 15:16:21,link,127,30,18,175
86680728811,"Active shooter incidents in the United States continue to rise in frequency, with new FBI statistics showing the highest average of incidents ever in a two-year period.",2016-06-15 17:58:24,link,164,96,25,285
112638779551,"""It was better than I anticipated"" said Tennessee Titans head coach Mike Mularkey.",2016-06-16 14:41:26,link,71,97,46,214
95926963131,Meghan King Edmonds isn't holding back about how hormones affected her during the early stages of her pregnancy. (via People Babies),2016-06-21 21:01:32,link,190,98,41,329
7245371700,Wow. no wonder she did what she did.,2016-06-18 03:02:33,link,125,1,25,151
25902406772,The LA Lakers may be looking to ship D'Angelo Russell.,2016-06-18 15:25:30,link,176,41,50,267
112638779551,Odell Beckham Jr dominated a charity softball game with moonshot home runs and huge bat flips.,2016-06-21 08:53:44,link,90,89,15,194
5281959998,"After the Orlando shooting, #TwoMenKissing became a reminder that the kiss — a small, universal symbol of love — has become more.",2016-06-19 00:25:00,link,188,84,40,312
25902406772,THE KING HAS DONE IT.,2016-06-19 21:38:40,photo,50,11,8,69
86680728811,Rapper Tupac Shakur would have turned 45 years old today. http://abcn.ws/1sI3n1b,2016-06-16 09:37:28,photo,84,36,17,137
95926963131,Taylor Swift has appeared to move on in a very big way—with Tom Hiddleston.,2016-06-15 17:08:37,link,31,94,10,135
10606591490,"""It's safe to say that if you work a corporate job with a corporate email account, your messages are likely being monitored.""",2016-06-17 01:00:23,link,189,70,20,279
112638779551,WWE has suspended Jerry Lawler indefinitely after the confrontation.,2016-06-17 07:55:55,link,64,88,28,180
86680728811,Candidate running for Congress in Florida launches contest on his Facebook page to give away a semi-automatic rifle on Independence Day.,2016-06-20 23:23:13,link,18,61,11,90
25902406772,History: DENIED.,2016-06-19 21:38:32,video,9,39,24,72
10606591490,The child is still missing.,2016-06-15 03:30:07,link,45,75,37,157
112638779551,"The whole course demands respect, but the U.S. Open Championship could hinge on these three shots.",2016-06-15 12:04:02,link,139,70,7,216
13652355666,"""Being a single dad is very rewarding,"" one dad says. ""I've been with him since the day he was born – actually we both have the same birthday.""",2016-06-18 21:41:00,link,134,16,27,177
75932763901,PREGNANT! Kourtney Kardashian's latest Instagram post has fans completely shocked –> http://bit.ly/28HWGNc,2016-06-18 20:45:00,photo,50,27,46,123
52150999700,Teen Wolf's Tyler Hoechlin totally has that Superman look down for Supergirl! 😍,2016-06-17 15:16:00,link,68,26,31,125
10606591490,"One man says he was told the alligators were ""harmless.""",2016-06-17 07:30:13,link,181,73,24,278
18807449704,"That's a whole lot of smoke and fire, SpaceX.",2016-06-15 11:43:56,link,56,45,16,117
112638779551,"If you need some motivation, Gregory is your guy!

Kristen Balboni for @TheBuzzer",2016-06-16 17:03:26,video,1,22,42,65
75932763901,PREGNANT! Kourtney Kardashian latest Instagram post has fans completely shocked –> http://bit.ly/28HWGNc,2016-06-16 18:30:00,photo,47,67,9,123
10606591490,Don't let your Facebook posts cost you a job.,2016-06-19 16:30:09,link,117,89,50,256
52150999700,The Notebook star in The Devil Wears Prada?! This would've changed EVERYTHING.,2016-06-23 21:19:38,link,124,25,38,187
112638779551,"The Cavaliers forced a Game 7, and NBA players were blown away by LeBron James' performance",2016-06-16 23:13:43,link,186,18,26,230
7245371700,Round 2: Taylor Swift VS. Tom Hiddleston,2016-06-22 08:43:19,link,181,7,3,191
52150999700,The Quantum Leap (TV series) legend recreated this epic moment in a whole new way. 😂,2016-06-16 17:56:00,link,15,84,40,139
13652355666,Should they leave or should they remain?,2016-06-23 05:15:39,link,173,26,23,222
25902406772,What a difference a team makes.,2016-06-17 21:29:03,link,135,66,12,213
112638779551,Repeating is hard. The Cleveland Cavaliers' lack of salary cap flexibility makes it harder.,2016-06-20 12:19:42,link,47,45,19,111
52150999700,The now-grown voice of Nemo lends his voice to a VERY different species in Finding Dory.,2016-06-20 01:09:00,link,179,15,35,229
7245371700,She's all grown up in The Neon Demon.,2016-06-22 21:10:47,link,191,47,34,272
13652355666,Microsoft has some high prospects for Kind Financial.,2016-06-18 15:20:00,link,169,67,26,262
18807449704,Some of Mindy Kaling's tribute T-shirts are downright depressing.,2016-06-19 09:35:35,link,177,80,10,267
18807449704,Can't unsee. 😱 😱,2016-06-18 14:55:00,link,163,70,43,276
13652355666,The move signals a huge shift for the typically conservative Bulls,2016-06-22 16:50:50,link,22,14,31,67
13652355666,BREAKING: Deeply divided Supreme Court upheld the use of racial preferences in admissions.,2016-06-23 09:46:49,link,49,62,32,143
95926963131,Star Trek actor Anton Yelchin has died at age 27.,2016-06-19 13:38:08,link,56,88,22,166
5281959998,The FDA found substandard equipment cleaning and employee hygiene at a Whole Foods Market plant.,2016-06-16 08:25:00,link,166,78,43,287
7245371700,"""We do have filming tomorrow, and it's not Minions 2.""",2016-06-20 20:45:19,link,21,85,26,132
52150999700,There's nothing better than a Saturday Night Live cast reunion!,2016-06-15 08:38:00,link,95,33,15,143
112638779551,"LeBron James was spectacular in the Finals, helping the Cleveland Cavaliers to a title. But he did something in this series that has never been done before.",2016-06-19 22:49:43,link,42,4,17,63
13652355666,"Imran Yousuf, 24, a bouncer at Pulse nightclub, risked his life to help lead people to safety.",2016-06-17 15:33:00,link,86,10,12,108
112638779551,"A reporter tried to bait LeBron James into a loaded Stephen Curry Q.

He wasn't having it.",2016-06-17 09:28:04,link,28,33,13,74
86680728811,"After Orlando massacre, Pres. Barack Obama calls on Congress to reinstate the assault weapons ban and pass legislation to make it harder for suspected terrorists to obtain firearms.",2016-06-15 00:55:09,link,110,83,46,239
25902406772,Zlatan Ibrahimovic may be on his way to Rio.,2016-06-15 15:31:20,link,154,29,4,187
112638779551,"""Two of the greatest words in the world, and that's Game 7."" LeBron James is on chill. #NBAFinals",2016-06-17 00:32:10,video,8,47,18,73
52150999700,"Fergie offered a first bite of her new single, and we love it. 🎶🔥",2016-06-18 10:15:00,link,57,48,31,136
7245371700,"""The LGBTQ community has always felt like home.""",2016-06-18 18:14:07,link,114,92,36,242
112638779551,Miesha Tate took aim at Ronda Rousey while appearing on Conan O'Brien Presents: Team Coco on Monday.,2016-06-21 11:23:53,link,8,46,39,93
10606591490,Derek Jeter retired at the ripe old age of 40.,2016-06-22 05:00:30,link,3,53,19,75
95926963131,Matthew McConaughey says fake boobs are overrated.,2016-06-22 15:49:00,video,79,37,33,149
52150999700,*Queue the Disney Channel nostalgia*,2016-06-22 06:37:00,link,192,21,10,223
95926963131,Patrick O'Brien has a special gift for his young son this Father's Day—one that took him 10 years to create.,2016-06-19 20:00:55,link,181,18,35,234
13652355666,An officer went above the call of duty to save 11 ducklings trapped in a drain on campus.,2016-06-19 17:10:00,video,50,22,40,112
5281959998,"Walt Disney World and Disneyland promise escape from the real world. After an alligator attack and the Orlando shooting, Disney has to work harder to pull that off.",2016-06-22 15:55:00,link,187,82,2,271
25902406772,LeBron James is coming up on Finals MVP history.,2016-06-19 23:22:24,link,189,14,1,204
86680728811,"Chaos erupts as House Democrats demand gun control vote, shout ""No bill, no break"" as Speaker Paul Ryan tries to gavel House to order to hold a vote on unrelated business. http://abcn.ws/28ParjI",2016-06-22 21:35:40,video,15,43,43,101
10606591490,"""We advised the individual they just needed to speak with the manager of the company and not the police.""",2016-06-22 01:00:47,link,190,98,30,318
75932763901,BABY JOY! Find out which star just welcomed her second child (via Closer Weekly) —> http://bit.ly/28LGfda,2016-06-21 14:00:00,photo,168,58,40,266
18807449704,Incredible,2016-06-21 07:30:00,link,75,80,29,184
18807449704,"Is that you, Nicole Kidman?",2016-06-19 17:42:37,link,160,38,37,235
25902406772,Not a good look for University of Miami football.,2016-06-23 14:03:02,link,56,21,40,117
13652355666,Ranger-in-chief.,2016-06-20 07:19:00,link,89,1,6,96
13652355666,Much of the investigation so far has focused on Omar Mateen's activities in the days before the massacre.,2016-06-15 17:41:11,link,196,17,17,230
25902406772,Not ideal.,2016-06-23 17:08:23,link,41,91,9,141
10606591490,"""People tend to feel better in summer months.""",2016-06-20 08:30:22,link,141,89,38,268
52150999700,Star Trek actor Anton Yelchin shockingly died Sunday after being pinned between his car and the gate of his home.,2016-06-20 12:02:11,link,199,31,48,278
95926963131,Prince William is speaking out on homophobic bullying. (via People Royals),2016-06-15 08:50:07,link,25,69,27,121
112638779551,"Eugene Monroe will continue his campaign to have the NFL remove marijuana from its list of banned substances, but it won't be as a member of the Baltimore Ravens",2016-06-15 21:26:33,link,129,90,34,253
13652355666,"Getting the next generation ""code ready.""",2016-06-20 13:54:00,link,82,95,36,213
86680728811,"In speech to supporters, Bernie Sanders doesn't suspend campaign, but vows to work with Hillary Clinton to defeat Donald J. Trump.  ""We do not need a major party candidate who makes bigotry the cornerstone of his campaign."" http://abcn.ws/1UC1QjQ",2016-06-16 19:48:43,video,83,53,35,171
10606591490,"Ahh, modern love",2016-06-15 18:30:11,link,20,78,12,110
75932763901,"What's happening to Blacc Chyna's baby bump? In just a matter of hours, her bump went from THIS to non existent! See the photo —> http://bit.ly/25XPHkl",2016-06-15 13:00:00,photo,105,99,3,207
25902406772,Derek Jeter is still the man.,2016-06-23 10:50:30,link,166,16,47,229
52150999700,HBO wasn't kidding when they said this would be Game of Thrones' biggest battle ever! 😱,2016-06-16 09:31:34,link,187,27,34,248
5281959998,"It has been a year since Dylann Roof killed nine people in a church in Charleston, S.C. We're speaking with some of the survivors as well as the victims' family members.",2016-06-15 16:19:42,video,96,21,26,143
112638779551,The Cleveland Cavaliers were welcomed home by thousands of fans when they arrived home in Cleveland Monday afternoon.,2016-06-20 14:09:30,link,145,67,23,235
7245371700,"Dwayne The Rock Johnson + Kevin Hart + Josh Horowitz + puppies = ADORABLE! Yep, the stars of Central Intelligence take on The Adorable Show.",2016-06-16 14:07:13,video,157,86,46,289
10606591490,"Complete with robot dance moves, a wedding—and lots of food.",2016-06-23 11:30:51,link,195,69,42,306
5281959998,"Kosta Karageorge hid his concussion symptoms because he thought it was the manly thing to do. On the night he went missing, the Ohio State Buckeyes wrestler and football player texted those closest to him, opening up about his pain and saying his goodbyes.",2016-06-22 04:26:36,link,16,49,28,93
52150999700,Could we BE any more nostalgic for the FRIENDS (TV Show) cast?! ❤️,2016-06-15 22:41:00,link,166,6,22,194
10606591490,Swanluv reviews candidates' relationships and sets an interest rate based on their compatibility.,2016-06-19 00:30:11,link,42,79,38,159
112638779551,Just because the Dallas Cowboys' minicamp is over doesn't mean Tony Romo and Dez Bryant are done working.,2016-06-16 18:25:32,link,114,32,10,156
86680728811,"Father gets tattoo to match his 8-year-old son's scar from having a brain tumor removed. ""He felt like a monster. I said, 'You know what, I'll get your scar tattooed. That way, if people want to stare at you, then they can stare at both of us.'""",2016-06-21 16:53:35,link,48,67,26,141
95926963131,Rachel Zoe certainly has her hands full—but she wouldn't have life any other way! (via People Babies),2016-06-15 09:56:05,link,27,26,34,87
25902406772,"Dang, already???",2016-06-20 15:00:37,link,46,2,26,74
13652355666,"#TBT This dress was too gorgeous for Duchess Kate to wear just once. http://usat.ly/28S2fTH (Photo: Stephen Pond, Getty Images)",2016-06-23 08:55:00,photo,84,40,38,162
7245371700,"In other words, J.K. Rowling is not a fan of spoilers.",2016-06-19 23:56:23,link,115,91,33,239
5281959998,"Damian Lewis, the British actor you may know from ""Homeland"" or ""Billions"" is talking with New York Times reporter Cara Buckley about his new movie ""Our Kind of Traitor"" and his career on stage and screen.",2016-06-23 18:06:49,video,84,59,10,153
95926963131,"Father's Day is approaching, so make sure your dad feels like the legend that he is.",2016-06-15 03:00:27,link,85,24,7,116
25902406772,The New York Mets are in some hot water with Tom Seaver's wife.,2016-06-22 09:52:26,link,107,56,6,169
7245371700,Reflecting on the great talent that he was and the brimming potential that he never got to reach.,2016-06-20 10:38:51,link,55,28,15,98
86680728811,A generation of FBI investigators has grown old and retired since the hunt began for the serial killer known as the Original Night Stalker.,2016-06-16 00:40:04,link,199,96,16,311
75932763901,HUGE BABY NEWS for Nicole Kidman and Keith Urban! Get the exciting details (via Closer Weekly) —> http://bit.ly/24DYFjy,2016-06-22 03:00:00,photo,196,77,5,278
52150999700,The legendary and beloved The West Wing series still resonates 10 years later. 🇺🇸,2016-06-22 18:19:00,link,59,95,2,156
95926963131,Botched is featuring the world's most identical twins ever.,2016-06-17 12:08:06,link,190,10,15,215
95926963131,Jeff Goldblum is extremely hands-on when it comes to his son.  (via People Babies),2016-06-17 13:36:04,link,91,57,13,161
10606591490,The best cities for your well-being.,2016-06-19 06:30:06,link,66,77,49,192
112638779551,"Donald ""Cowboy"" Cerrone won another bonus on Saturday but he's still not happy with his current pay with the UFC.",2016-06-19 02:45:17,link,189,84,11,284
25902406772,Weighing in on the Golden State Warriors historic season.,2016-06-20 09:24:41,link,198,92,4,294
25902406772,Stephen Curry costs about as much as a Game of Thrones episode.,2016-06-19 12:37:03,link,101,19,45,165
10513336322,"""Meet Magnus Nilsson. He is considered one of the greatest chefs in the world. One of his signature dishes is a single scallop poached in its own juices, which arrives at your table in its gigantic shell atop a bed of moss and burning juniper branches.""",2016-06-23 12:20:00,link,198,1,32,231
10513336322,A Chicago singer who appeared on the Mexican version of The Voice in 2011 has died after he was shot in an ambush while celebrating his birthday with friends.,2016-06-19 03:00:00,link,86,1,7,94
10606591490,3. Superfoodify your smoothie.,2016-06-17 19:01:00,link,108,38,46,192
112638779551,Kevin Durant has a big decision this summer as teams will be lined up trying to lure the superstar from the Oklahoma City Thunder.,2016-06-20 15:53:36,link,57,91,3,151
52150999700,"Disney execs are ""devastated and heartbroken"" over two-year-old's tragic death.",2016-06-15 21:31:54,link,33,8,43,84
13652355666,House Democrats #HoldTheFloor over gun legislation. http://usat.ly/28OZG5N,2016-06-22 13:24:00,video,109,59,30,198
18807449704,Try to avoid using these words.,2016-06-15 02:00:00,link,93,97,44,234
10513336322,"""The Cristiano Ronaldo at Euro 2016 is a force on the wane.""",2016-06-19 07:12:00,link,147,59,34,240
86680728811,"American woman who underwent female genital mutilation comes out of the shadows to help others. ""[It's] child abuse, and it's something that is happening to a girl that doesn't have the capacity yet to consent to it."" http://abcn.ws/28Owgon",2016-06-22 09:03:48,video,23,13,30,66
86680728811,"Ayesha Curry, wife of Golden State Warriors star Stephen Curry, says her now-deleted post-Game 6 tweet slamming refs was 'tweeted in the heat of the moment.' http://abcn.ws/1W2HBRv",2016-06-16 23:25:05,photo,32,15,25,72
112638779551,Looks like Rory MacDonald is headed to surgery following his loss to Stephen Wonderboy Thompson.,2016-06-19 03:22:34,link,112,75,47,234
52150999700,The beloved Looking series is finally getting the finale it deserves on HBO.,2016-06-20 16:53:00,link,113,74,39,226
10513336322,Can Tesco turn around the supermarkets food waste problem?,2016-06-15 14:30:01,link,22,38,38,98
75932763901,"""He beats me. He's going to kill me."" This famous actress was rushed to the hospital after having a scary breakdown in front of her 4-year-old son —> http://bit.ly/28NXVDT",2016-06-21 14:30:00,photo,66,78,35,179
5281959998,Research shows that young people can overcome their fear if they return to a site of trauma. Read on in The New York Times Opinion Section.,2016-06-17 08:55:01,link,102,72,13,187
5281959998,Lawmakers who have championed discriminatory laws should force themselves to read the obituaries and look at the photos of the people killed in Orlando. Read on in The New York Times Opinion Section.,2016-06-15 06:55:00,link,191,10,9,210
7245371700,"We're only halfway through 2016, but shows like Broad City + The People v. O.J. Simpson: American Crime Story are dominating the TV world.",2016-06-16 20:48:03,link,15,74,31,120
18807449704,House Democrats end gun sit-in.,2016-06-23 23:00:00,video,19,74,7,100
52150999700,Give Amy Schumer a spot on the show already! 😂,2016-06-17 20:09:00,link,38,44,50,132
75932763901,FINALLY! Kelly Clarkson has been seen in public for the first time since welcoming Baby No. 2! See the pic (via Closer Weekly) —> http://bit.ly/1YewTaM,2016-06-16 06:45:01,photo,12,53,13,78
52150999700,*Adds to Spotify playlist ASAP* 🎶,2016-06-18 22:41:00,link,103,62,32,197
95926963131,"Today, Britons head to the polls for a referendum on whether they'll remain in the European Union.",2016-06-23 08:02:06,link,151,26,47,224
5281959998,The $3.1 billion expansion of the Panama Canal is one of the world's biggest and most important construction projects. It's not going as planned.,2016-06-22 12:55:26,link,42,62,28,132
52150999700,"This song is so touching, Melissa Etheridge.",2016-06-15 16:10:00,link,96,70,5,171
112638779551,Draymond Green got one last kick in for the road at the end of Game 7.,2016-06-21 14:03:48,link,77,52,22,151
18807449704,Your Apple Watch is about to get the nearest thing to a brain transplant this fall.,2016-06-15 20:26:01,link,12,54,41,107
75932763901,"Gwen Stefani takes it ALL OFF on social media! When you see the revealing pic, you'll understand why it got over 100,000 likes! –> http://bit.ly/1XCbc4j",2016-06-23 20:00:00,photo,145,33,45,223
7245371700,I can't keep up with Kylie Jenner's hairstyles anymore.,2016-06-19 17:16:53,link,103,67,19,189
25902406772,Texas Rangers pitcher Colby Lewis was soooo close.,2016-06-16 18:30:05,link,155,73,46,274
95926963131,Vicki Gunvalson decided to take some time to focus on herself post-breakup.,2016-06-22 12:31:05,link,57,13,39,109
13652355666,So tragic.,2016-06-23 13:30:00,link,101,66,26,193
25902406772,Odell Beckham Jr absolutely MASHES homers when he uses the Happy Gilmore swing.,2016-06-20 23:55:18,video,42,68,27,137
18807449704,The Tonight Show Starring Jimmy Fallon just helped Dwayne The Rock Johnson take a big culinary step.,2016-06-17 16:30:00,link,134,44,15,193
18807449704,Browsing Netflix just got a lot easier.,2016-06-24 01:00:00,link,133,7,49,189
86680728811,"Oprah Winfrey: ""Regardless of your politics, you cannot be a woman in the world and not see that this is a monumental time for women breaking the ceiling. Talk about breaking the ceiling!"" http://abcn.ws/265iU9N",2016-06-16 08:15:32,link,98,83,45,226
86680728811,"Donald J. Trump says guards or employees should have had guns at Orlando nightclub. Previously he argued that ""some of those wonderful people"" or ""some of the people killed"" should have ""happened to have"" a gun.",2016-06-20 07:57:18,link,133,100,6,239
7245371700,Why have Senate Republicans blocked so many of Obama's appointments?,2016-06-15 15:16:32,video,124,4,45,173
18807449704,Whoops. 😱,2016-06-19 19:00:01,link,71,42,22,135
86680728811,"Singer Meat Loaf collapsed on stage during concert in Canada due to ""severe dehydration,"" his rep says. http://abcn.ws/1UDsqcd",2016-06-17 08:56:58,video,29,57,19,105
5281959998,"YouTube and Google.
Instagram and Facebook.
Tumblr and Yahoo.
LinkedIn and Microsoft.
Twitter and … ?",2016-06-16 12:55:00,link,123,98,11,232
25902406772,Facts are facts...,2016-06-20 14:09:50,photo,88,66,49,203
52150999700,Parents looking for a 21st-century E.T. The Extra-Terrestrial to share with their kids are bound to be a bit disappointed even as their eyes are dazzled.,2016-06-23 11:02:02,link,36,41,1,78
95926963131,It wasn't Blake Lively's dress itself that stirred up conversation quite as much as the Instagram she posted about it.,2016-06-21 20:00:14,link,76,32,15,123
7245371700,She may be Disney's toughest princess yet.,2016-06-19 01:44:01,link,90,95,10,195
25902406772,Metta World Peace is all about the NBA's integrity.,2016-06-17 18:13:28,link,40,46,35,121
86680728811,"The wife of the Orlando nightclub shooter had learning difficulties when she was in middle school and was enrolled in special education classes, according to her now retired teacher in California. http://abcn.ws/1UIcENt",2016-06-19 13:01:28,link,53,23,31,107
112638779551,The Golden State Warriors reportedly will be without Andrew Bogut for the remainder of the NBA Finals.,2016-06-15 11:05:31,link,48,81,7,136
86680728811,First Lady Michelle Obama says the Orlando tragedy should be a moment for the country to unify: http://abcn.ws/21mt3f1,2016-06-15 10:10:00,link,105,10,4,119
18807449704,Hearts were broken,2016-06-17 06:00:01,link,99,22,4,125
10513336322,"""Hatred is a terrible thing, but I have no idea what other response there could possibly be to a man such as Philip Green. The man is like a cancer: seemingly determined to grow and spread his little empire with no concern whatsoever for the effect that it may have on others.""

- anonymous BHS employee",2016-06-15 04:39:38,link,86,84,18,188
75932763901,Halle Berry's rarely-photographed daughter is all grown up! Wait until you see Nahla today (via Closer Weekly) —> http://bit.ly/25AYB7f,2016-06-18 08:30:00,photo,196,1,35,232
75932763901,Well this is EMBARRASSING! Check out whose booty was totally EXPOSED by a gust of wind! –> http://bit.ly/1YcPOme,2016-06-20 09:00:00,photo,136,59,46,241
86680728811,"Seattle teen feels 'awake' again after receiving a heart transplant the day after celebrating prom in the hospital. ""My mind has sprung back into action.""",2016-06-21 08:04:36,link,197,2,17,216
52150999700,"Chekov and Anton Yelchin were more alike than you may know, Star Trek fans.",2016-06-19 16:12:39,link,50,65,15,130
5281959998,"""Airbnb can say it doesn't condone racism and even has an anti-discrimination policy, but right now that policy doesn't have teeth.""",2016-06-19 20:55:00,link,45,45,15,105
5281959998,Time for The Upshot to cross Cleveland off the list.,2016-06-19 22:39:00,link,66,57,5,128
10513336322,"""The chemistry has been impossible to emulate, and has not been helped by reports of internal tensions on the new show.""",2016-06-20 13:23:38,link,192,91,38,321
5281959998,Senator Chris Murphy claimed victory shortly before 2 a.m. on Thursday after a 15-hour filibuster.,2016-06-16 10:25:00,link,20,6,10,36
86680728811,"A Chicago singer who appeared on the Mexican version of ""The Voice"" in 2011 has died after he was shot in an ambush while celebrating his birthday with friends.",2016-06-19 02:28:08,link,3,73,21,97
112638779551,"Michael Jordan has had some great Game 6s, but he's not No. 1.",2016-06-16 08:26:53,link,75,31,3,109
13652355666,Some aspects of successful fatherhood are timeless. Via USA TODAY Opinion,2016-06-16 14:49:00,link,146,47,1,194
10606591490,Always tired? This could be why.,2016-06-15 04:30:25,link,190,95,6,291
5281959998,"Juma was shot after she moved toward a soldier, the military said.",2016-06-22 05:55:00,link,88,63,16,167
10513336322,"""I remember thinking: if only the people who live in freedom knew what we were going through, they would certainly help us.""",2016-06-19 02:00:01,link,128,10,12,150
7245371700,It all goes down on the Teen Mom 2 reunion tonight.,2016-06-20 15:54:34,video,188,25,9,222
86680728811,"1 in 6 dollars that Donald J. Trump spent during the month of May went to his own businesses, his family or himself, according to ABC News analysis of campaign finance records.",2016-06-22 00:40:10,link,38,46,6,90
25902406772,The Chicago Blackhawks star has made MVP history.,2016-06-22 23:26:01,link,81,87,38,206
75932763901,AWKWARD! Prince William gets scolded in public by his grandmother Queen Elizabeth — wait until you see his reaction! (via Closer Weekly) —> http://bit.ly/261xRNn,2016-06-17 13:30:00,photo,70,57,42,169
75932763901,CONGRATS! Find out who welcomed a baby girl —> http://bit.ly/1ZRi90k,2016-06-15 22:30:00,photo,156,45,41,242
13652355666,"The decision is a controversial one, because tens of thousands of U.S. citizens have warrants for minor traffic infractions.",2016-06-20 11:50:00,link,148,34,4,186
7245371700,Keep them coming Kanye.,2016-06-19 04:57:02,link,145,61,42,248
7245371700,Iggy Azalea is heading back down under.,2016-06-20 05:12:09,link,126,41,2,169
112638779551,"Kevin Love would have been the one to blame if the Cleveland Cavaliers had lost the title. Instead, he was one of players partying the hardest.",2016-06-19 23:56:29,link,55,86,16,157
112638779551,The news clears the way for the return of one of Alabama Football's most important players.,2016-06-20 14:01:33,link,159,62,20,241
13652355666,Elon Musk inhabits a world of declarative superlatives.,2016-06-22 22:20:00,link,30,98,40,168
18807449704,Can't handle the ❤️,2016-06-22 05:55:20,link,167,58,10,235
18807449704,Here's to more uplifting campaigns like this.,2016-06-21 10:10:06,link,176,38,1,215
112638779551,"Think it's easy to work for Alabama Football coach Nick Saban? Think again. 

Former Tennessee Football coach Derek Dooley shared a story on Outkick with Clay Travis Thursday, about just how crazy Saban's work ethic is...",2016-06-17 16:22:16,link,24,82,19,125
25902406772,"Stephen Zimmerman's family made him #DreamFearlessly. On Thursday, he'll fulfill his dreams at the Draft with American Family Insurance.",2016-06-20 18:31:51,video,191,24,6,221
18807449704,You'll be kicking yourself for not thinking of this. 😂,2016-06-16 12:10:09,link,187,11,30,228
5281959998,Republicans worry that they have a historic loser on their hands.  Read on in The New York Times Opinion Section.,2016-06-22 07:55:01,link,79,61,30,170
7245371700,Nick Jonas does it all.,2016-06-18 13:30:54,link,62,48,30,140
86680728811,"The Boulder County Justice Center allows service animals into the building, but security guards drew the line when someone tried to sneak his pet iguana through the X-ray machine.",2016-06-18 00:42:42,link,121,56,8,185
18807449704,WHAT HAVE YOU DONE!? 😱,2016-06-17 11:28:18,link,17,93,45,155
52150999700,The Breakfast Club is the BEST high school movie of all time! 👌🏼,2016-06-18 06:31:00,link,87,91,48,226
95926963131,@[Hamilton: An American Musical] tickets aren't completely impossible to get!,2016-06-19 01:00:16,link,20,68,37,125
52150999700,This is incredibly sad news. Our thoughts are with the Varsity Blues star's family.,2016-06-17 17:33:06,link,43,36,5,84
5281959998,Refreshing with a kick.,2016-06-21 17:55:00,link,82,46,14,142
112638779551,"From the driving range to the 18th green, Lexus has you covered. 

Tune in LIVE to the FOX Sports broadcast using the NextVR app now!",2016-06-17 09:26:08,link,195,48,17,260
95926963131,Fans are mourning the loss of a beloved Orange Is the New Black character after an unexpected farewell.,2016-06-19 08:20:06,link,174,11,47,232
10606591490,From Lorde to Daisy Ridley.,2016-06-21 21:30:53,link,61,28,10,99
18807449704,"""You uphold antiquated, strident, unbalanced and frankly sexist standards when it comes to female students and how they dress at school. That's a problem.""",2016-06-24 08:39:48,link,56,25,46,127
10606591490,Forgiving other people is good for your health. http://ti.me/21oVAk1,2016-06-18 19:00:40,video,17,63,9,89
25902406772,LSU Football has a rich history.,2016-06-23 10:46:41,link,38,61,17,116
25902406772,Here are some of the longest droughts in baseball.,2016-06-20 12:43:42,link,10,15,24,49
112638779551,"Don't get caught sleeping on a free kick.

Nicole Dabeau for @TheBuzzer.",2016-06-15 21:10:04,video,9,74,36,119
7245371700,"What it's like being LGBTQ and Muslim: ""I wake up every morning and I wonder which identity I'm going to be killed for today.""",2016-06-21 12:14:14,video,78,85,6,169
95926963131,Detectives are investigating the unsolved murder of an 16-year-old boy who was found lying dead on the side of the road.,2016-06-22 20:35:04,link,46,50,12,108
112638779551,Listen to Stanford Football's Christian McCaffrey cover Piano Man on a harmonica,2016-06-18 10:31:49,link,103,62,47,212
10606591490,"Matthew McConaughey: ""I miss Rust Cohle, man.""",2016-06-24 00:30:11,link,15,75,12,102
86680728811,"12,400,000 people were newly displaced by conflict or persecution in 2015. That's 24 people a minute. http://abcn.ws/28JWGHG",2016-06-20 16:52:01,video,75,37,20,132
10606591490,Sometimes a glance can tell you how smart someone is.,2016-06-16 01:00:05,link,146,87,14,247
5281959998,The Black Lives Matter movement has crossed north of the border.,2016-06-16 00:55:01,link,184,40,15,239
18807449704,"This is brilliant work, Internet.",2016-06-19 11:08:10,link,60,3,5,68
5281959998,"""The Supreme Court issued a terrible Fourth Amendment ruling. In a powerful dissent, Justice Sonia Sotomayor took it apart,"" the Editorial Board argues in The New York Times Opinion Section.",2016-06-20 21:25:00,link,192,53,10,255
7245371700,"Pretty Little Liars showrunner I.Marlene King gives an exclusive scoop on the all the ""epic"" romance to come this season.",2016-06-16 17:59:38,link,82,48,35,165
5281959998,Daily Briefing: Here's what you need to know today.,2016-06-20 05:30:48,link,39,10,43,92
86680728811,Hillary Clinton says Donald J. Trump would be dangerous for the economy and that just because he's spent his life as a businessman voters shouldn't assume he's prepared to be President.,2016-06-21 15:02:00,link,120,7,19,146
10606591490,"""The whole 'chick-flick' idea is an excuse for guys not to have to see something.""",2016-06-23 00:30:11,link,135,31,24,190
112638779551,BREAKING: Derrick Rose reportedly is heading from the Chicago Bulls to the New York Knicks in a blockbuster deal.,2016-06-22 14:41:13,link,65,29,12,106
52150999700,Arrow is about to get a shock from this The Walking Dead star turned villain. 😱,2016-06-21 16:52:00,link,135,71,5,211
5281959998,"Melissa McCarthy, Kristen Wiig and the rest of the squad discuss the controversy around the all-female take on Ghostbusters.",2016-06-21 06:25:00,link,33,97,35,165
7245371700,"""Power suits are for pop music queens, and we can either suit up in solidarity or get out of their way.""",2016-06-22 19:51:08,link,3,26,6,35
112638779551,Can any AL catcher handle the job of catching the Boston Red Sox knuckleballer?,2016-06-22 13:38:06,link,121,59,24,204
5281959998,"This author calls gerrymandering ... well, a word we won't print in The New York Times Books.",2016-06-21 21:10:00,link,147,54,42,243
13652355666,Whoa. The system is reportedly capable of 93 million billion calculations per second.,2016-06-21 08:05:00,link,187,54,1,242
25902406772,PENALTY KICKS. DRAMA. YES.,2016-06-17 22:20:36,link,77,40,26,143
25902406772,Chandler Parsons opts out and will become a free agent.,2016-06-22 09:00:11,link,185,48,16,249
5281959998,"""I've never been ejected before, so it was a weird feeling,"" Stephen Curry said after game 6 of the NBA finals.",2016-06-17 09:41:29,link,75,15,1,91
75932763901,CONGRATULATIONS! Find out which beloved star has a THIRD child on the way —> http://bit.ly/28QMxnT,2016-06-24 09:30:00,photo,133,86,24,243
86680728811,Security is being ramped up at LGBT nightclubs and events across the country in the wake of the Orlando shooting. http://abcn.ws/1UDOfs9,2016-06-17 12:48:49,link,149,100,24,273
10513336322,Analysis: would George Osborne really opt for austerity max in his post-Brexit budget?,2016-06-15 07:40:01,link,195,81,3,279
112638779551,Brother of party rocker Andrew W.K. is the long shot you should be rooting for at the U.S. Open Championship.,2016-06-16 12:26:34,link,60,87,49,196
95926963131,Katie Holmes is a vision in white while filming scenes for the upcoming tv miniseries The Kennedys - After Camelot.,2016-06-21 16:25:06,link,109,74,23,206
75932763901,"Um, congratulations Kylie Jenner?! 🍼👶",2016-06-21 10:02:20,link,50,96,49,195
95926963131,The son of former Real Housewives of Orange County star Lauri Peterson allegedly shot a man in the torso.,2016-06-21 09:41:04,link,101,23,16,140
86680728811,"Alaska Airlines passenger arrested in Seattle attempted to kiss a 16-year-old girl sleeping in the seat next to him before the pilot was notified, official says.",2016-06-22 00:18:07,link,109,45,5,159
13652355666,The Republican primaries drew more than 30 million voters.,2016-06-16 21:05:00,link,88,40,29,157
95926963131,"If you want to hang with Taylor Swift, Tom Hiddleston, you gotta get with her friends.",2016-06-15 17:30:11,link,178,14,41,233
25902406772,Los Angeles Dodgers ace Clayton Kershaw should be the NL's guy.,2016-06-23 09:48:32,link,135,81,35,251
10606591490,"Nearly 12,000 pregnant women in Colombia have Zika. http://ti.me/1Yvjyuz",2016-06-16 18:00:41,video,196,90,36,322
86680728811,Donald J. Trump has raised less money from donors in the month of May than any major-party nominee since 2000.,2016-06-21 11:44:45,link,119,85,12,216
95926963131,Joan Rivers' personal items are available for auction at Christie's today.,2016-06-16 08:28:04,link,7,79,30,116
10606591490,Lindsay Lohan wants you to know the U.K. should remain.,2016-06-23 21:30:49,link,139,52,14,205
86680728811,Attorney General Loretta Lynch tells This Week the Justice Department is looking at what the FBI could have done differently in response to warnings about Orlando shooter Omar Mateen: http://abcn.ws/1UVK4uA,2016-06-19 09:03:48,video,26,49,46,121
95926963131,Chloë Moretz is wise beyond her years.,2016-06-23 20:08:35,link,152,96,13,261
75932763901,"Welcome to the world, Skyla! Click here to reveal this beauty's famous mama —> http://bit.ly/1UeSiRp",2016-06-16 23:30:01,photo,16,55,34,105
86680728811,"Nearly 2 million children may be suffering sports- and recreation-related concussions every year, and many of those may go untreated, according to a new study.",2016-06-21 03:31:10,link,121,33,8,162
7245371700,"From Gilmore Girls to Harry Potter, these fandoms need your help: http://on.mtv.com/28PfUeW",2016-06-22 17:00:00,photo,124,8,39,171
10513336322,"""Ryan, who was in his 20s, and I were at opposing ends of the domestic hygiene spectrum. He had never learned how to clean, while I had lived in my own place for years, developing my own standards.""",2016-06-20 13:00:00,link,183,92,18,293
52150999700,"Rest assured, Star Wars fans: The Force is strong with the #RogueOne directors. 🙌",2016-06-23 16:01:42,link,169,10,37,216
95926963131,Graswald is accused of drowning her fiancé during a kayaking trip last year. (via People True Crime),2016-06-22 14:43:12,link,150,95,46,291
18807449704,Just going to leave this here...,2016-06-21 07:03:45,link,78,74,42,194
10513336322,"Members of Orlando's LGBTQ community were invited up to one church's altar to be prayed over. Many accepted, rose from their seats and stood tall in front of the congregation.",2016-06-15 08:00:00,link,49,86,6,141
95926963131,Amber Heard has been keeping a low profile amid her legal battles with Johnny Depp.,2016-06-23 14:42:33,link,171,68,33,272
13652355666,"Einstein = right, again!",2016-06-15 19:07:00,link,180,1,6,187
52150999700,Jim Carrey is Here is not kidding around.,2016-06-21 19:59:00,link,197,97,30,324
7245371700,"""When you're gay, music and celebration go hand in hand with survival, proclaiming to the rest of the world that you exist, that you are worthy of love.""",2016-06-18 08:24:05,link,200,25,50,275
112638779551,"With a leadoff single Wednesday, Miami Marlins outfielder Ichiro Suzuki ""ties"" Pete Rose atop the all-time hits list.",2016-06-15 15:19:42,link,174,61,47,282
13652355666,"""I'm just a kid from Akron, Ohio,"" he said.",2016-06-20 15:35:48,link,29,42,21,92
112638779551,"The Cleveland Cavaliers want to win an NBA title, of course. More than that, though, they don't want to disappoint their leader, LeBron James.",2016-06-16 16:23:02,link,116,51,35,202
112638779551,The Cleveland Cavaliers are playing host to a watch party for Game 7 of the NBA Finals. Now watch as the secondary market prices erupt.,2016-06-17 13:10:29,link,70,61,24,155
10513336322,"""We'd recommend Cristiano Ronaldo take a long hard look at himself in the mirror, if we didn't know that he already spends several hours a day doing exactly that.""",2016-06-15 06:10:00,link,68,37,47,152
13652355666,It was a long night for the Currys.,2016-06-17 06:31:00,link,149,68,42,259
52150999700,Usher releases slick dance moves and tears in this beautiful video. 🙏,2016-06-19 04:49:00,link,165,28,19,212
10606591490,Bethenny Frankel spoke out about her own miscarriage and struggle with the ailment.,2016-06-22 21:30:30,link,41,50,1,92
25902406772,A closer look at the Derrick Rose to New York Knicks trade.,2016-06-22 15:58:13,link,80,72,17,169
25902406772,"The NBA season is over. But between the big trade and the draft, there is PLENTY to talk about.",2016-06-22 17:37:27,link,25,56,24,105
75932763901,WHOA! This sexy star is causing a stir after flaunting her enviable bod in a late-night Instagram pic —> http://bit.ly/28Oaehn,2016-06-23 10:00:00,photo,63,17,26,106
13652355666,The results of the #Brexit vote are due Friday morning – more than enough time to drive a wedge between families who are voting today.,2016-06-23 12:29:00,link,133,63,4,200
5281959998,Anton Yelchin's death casts a spotlight on why Fiat Chrysler has still not come up with a fix for the problem with Jeeps.,2016-06-21 21:25:00,link,186,10,23,219
75932763901,BABY NEWS! Click here for the Beyoncé and JAY Z news you've been waiting for (via Life & Style Weekly) —> http://bit.ly/28NxboI,2016-06-23 06:00:00,photo,71,2,2,75
95926963131,Fans of Priyanka Chopra's pointed out the Maxim Photoshop fail on social media.,2016-06-20 13:14:04,link,76,97,31,204
25902406772,Here is your NFL preseason primer.,2016-06-15 16:40:38,link,82,99,20,201
5281959998,It's official: Lin-Manuel Miranda is leaving Hamilton: An American Musical (but he might come back).,2016-06-16 11:52:46,link,143,21,21,185
5281959998,"To preserve his privacy, Daniel Radcliffe keeps away from social media platforms. He's never tried online dating; he doesn't Instagram his meals.",2016-06-22 16:55:00,link,130,15,18,163
10606591490,Look's like Trump's a fan of fast food.,2016-06-15 22:30:09,link,27,94,39,160
10513336322,"The new £46m jet, which can fly non-stop from Hong Kong to New York, was delivered just weeks before the Green family's new superyacht – a four-storey 90-metre vessel built in Italy that is understood to have cost the billionaire £100m.",2016-06-20 02:40:01,link,53,79,38,170
112638779551,The New York Knicks couldn't have trolled the Chicago Bulls any harder after getting Derrick Rose.,2016-06-23 13:10:27,link,138,65,47,250
13652355666,"""I'm in ruins.""",2016-06-19 16:44:27,link,81,33,42,156
75932763901,What do you think of his moniker?!,2016-06-24 23:30:00,link,170,57,12,239
52150999700,"Just great recipes, no meth-ing around here, Breaking Bad fans!",2016-06-23 23:08:01,link,183,25,37,245
7245371700,Which famous ex deserves a Taylor Swift greeting card?,2016-06-16 19:34:38,link,73,82,14,169
86680728811,"Two year old bursts into tears after presenting Queen Elizabeth II with flowers when she arrived to open Alderhey Children's Hospital in Liverpool, England.",2016-06-22 10:30:39,photo,187,6,47,240
52150999700,Dory's fascinating journey of how she just kept swimming in Finding Nemo is seriously amazing. 🐠,2016-06-16 15:22:00,link,21,11,13,45
5281959998,"Donald J. Trump wants to ""suspend immigration from areas of the world when there is a proven history of terrorism.""

That could affect American citizens traveling and living abroad.",2016-06-18 12:54:00,link,129,48,37,214
95926963131,These adults took to Reddit to open up about what's stopped them from losing their virginity.,2016-06-20 17:18:03,link,66,14,29,109
7245371700,My eyes have definitely opened up more to who Justin Bieber is as a person.,2016-06-18 18:43:11,link,178,66,12,256
112638779551,The Atlanta Hawks reportedly have traded Jeff Teague to the Indiana Pacers in a 3-team trade that includes the Utah Jazz.,2016-06-22 13:41:05,link,198,89,23,310
10606591490,It just got easier to fly drones for money. http://ti.me/28O1RS9,2016-06-22 12:45:48,video,156,68,25,249
7245371700,I spy with my little eye the Spy Kids boy all grown up. (via AOL),2016-06-18 04:15:04,link,13,71,42,126
10606591490,2. Label negative feelings.,2016-06-18 10:00:54,link,23,49,25,97
13652355666,"""There's been a lot of news about prejudice and bias on our platform, and this is a huge issue for us.""",2016-06-22 18:58:00,link,176,48,19,243
13652355666,"""It's not over for me.""",2016-06-21 00:00:00,link,95,94,40,229
18807449704,"No matter where you're at in your career, learning something new can only help you.",2016-06-16 03:00:00,link,194,40,15,249
13652355666,Anton Yelchin's freak fatal accident gets even stranger.,2016-06-20 17:00:00,link,111,52,44,207
52150999700,Meet the stars of the next generation of Mad TV! 😄,2016-06-15 15:32:00,link,171,92,49,312
86680728811,"An emu runs to escape an approaching wildfire as it burns near Potrero, California. abcn.ws/28LIaPC",2016-06-21 11:31:06,photo,135,32,48,215
10513336322,"""Where does this stop? Are we going to start treating all Muslim-Americans differently? Are we going to start subjecting them to special surveillance? Are we going to start discriminating against them because of their faith? Do Republican officials actually agree with this?""",2016-06-15 01:40:00,video,114,75,49,238
112638779551,"""They just told me it was the biggest mistake I was making in my career."" And that's why you should never doubt LeBron James",2016-06-20 12:37:00,link,174,87,41,302
52150999700,Say hello to Adele's music on Spotify! 🙏,2016-06-23 11:26:42,link,76,21,18,115
112638779551,"Stephen Curry is cool and all, but we're good, thanks.",2016-06-15 14:49:02,link,174,37,31,242
7245371700,"Aww, so glad they kept the OG Nemo in this way.",2016-06-22 03:46:18,link,89,13,18,120
52150999700,Chris Pratt and his Guardians of the Galaxy stunt double could seriously be (very handsome) twins! 🔥✌️,2016-06-17 11:22:00,link,84,55,21,160
25902406772,"The legacy of LeBron James. Cleveland's long wait being over. A message to the haters. 

Adam Schein hits it all.",2016-06-20 22:22:48,video,117,39,11,167
25902406772,"Colon notched his third-career double, striking a well-placed line drive to right field.",2016-06-17 11:05:40,link,59,51,13,123
10606591490,"""I see these people all the time. On the outside they look incredibly healthy, but on the inside they're a wreck.""",2016-06-18 05:30:19,link,8,8,1,17
5281959998,Microsoft is breaking the corporate taboo on pot.,2016-06-16 22:25:00,link,131,77,2,210
95926963131,Queen Elizabeth II is not afraid of a little color! 💃 (via HelloGiggles),2016-06-23 02:00:06,link,197,12,29,238
7245371700,I'm sure you have the same questions about Pretty Little Liars that I do...,2016-06-23 18:50:08,link,186,32,47,265
5281959998,Looking for something to watch this week? Look no further. (via NYT Watching),2016-06-20 18:10:00,link,93,53,14,160
7245371700,"You may have known your dad your whole life, but have you had these convos with him? (via AskMen)",2016-06-19 22:27:07,link,96,71,37,204
25902406772,Keep this handy on draft night.,2016-06-22 19:14:54,link,175,35,34,244
10513336322,A look back at episode nine of the sixth season of Game of Thrones.,2016-06-20 14:30:00,link,138,98,15,251
112638779551,Bulldogs in the house.,2016-06-22 10:28:14,link,59,65,32,156
13652355666,It's the first time in nearly 70 years that there has a been a full moon on the summer solstice.,2016-06-20 19:55:00,link,149,92,42,283
25902406772,Sergio loves birdies of every kind.,2016-06-19 17:00:42,link,123,70,34,227
52150999700,"In a super sweet gesture, Jenna Coleman sent flowers to Doctor Who's new companion: http://share.ew.com/CNnW3u9 ❤️",2016-06-21 18:44:00,video,76,59,28,163
75932763901,"Just months after stepping out with his new girlfriend, John Stamos has received some VERY exciting news! Get the latest (via Closer Weekly) —> http://bit.ly/1XtC07F",2016-06-17 21:30:00,photo,109,39,28,176
112638779551,Welcome to the mind of a Cleveland sports fan.,2016-06-19 04:34:44,link,17,59,18,94
7245371700,I can't keep up with Kylie Jenner's hairstyles anymore.,2016-06-21 03:48:27,link,78,60,9,147
25902406772,Ichiro Suzuki has been racking up hits forever.,2016-06-15 18:09:56,link,66,44,40,150
52150999700,This is the PERFECT trip for all The Walking Dead fans! (via FanSided),2016-06-20 02:28:00,link,4,63,14,81
25902406772,This is much more than basketball.,2016-06-20 00:53:13,link,191,14,1,206
95926963131,Prince Harry fielded one young girl's surprise proposal like a pro!,2016-06-21 18:58:02,link,104,63,40,207
112638779551,With the second pick in the 2016 NBA Draft the LA Lakers select Brandon Ingram.,2016-06-23 18:45:35,photo,182,9,9,200
10513336322,"Police have been alerted to the possibility that small groups of extremists have left Syria for France and Belgium with plans to stage attacks, but have left threat levels unchanged while authorities work to determine how credible the information is.",2016-06-15 13:30:00,link,143,20,16,179
95926963131,Chris Brown's legal woes continue.,2016-06-23 19:02:05,link,165,52,13,230
25902406772,Stephen Curry shut down this alley-oop attempt.,2016-06-19 20:56:13,link,32,41,12,85
18807449704,This. Is. Priceless. 😂,2016-06-22 21:34:36,link,160,71,24,255
10606591490,A peek into kitchens from Norway to Kuwait.,2016-06-18 22:30:13,link,92,25,1,118
7245371700,I missed this look.,2016-06-15 09:26:38,link,55,28,6,89
10513336322,"""I'm a contradiction. Like Mary, virgin and mother. Like man, good and evil.""",2016-06-15 08:40:00,link,39,4,41,84
10606591490,Ouch.,2016-06-17 11:30:31,link,158,89,45,292
18807449704,Coffee probably doesn't cause cancer but this other type of beverage might raise cancer risk.,2016-06-15 12:07:58,link,198,81,45,324
52150999700,"On  American Gothic, NOTHING is what is seems. 😱",2016-06-21 20:37:00,link,178,77,12,267
95926963131,A key character said goodbye in Sunday's episode of Game of Thrones.,2016-06-20 07:22:05,link,184,82,46,312
7245371700,Cut. It. Out. So stoked to finally meet this character.,2016-06-23 10:37:50,link,154,43,5,202
112638779551,"This guy takes yoga to the next level! Namaste. 

Kristen Balboni for @TheBuzzer",2016-06-20 13:42:30,video,91,72,24,187
86680728811,First funerals for Orlando nightclub shooting victims to be held today.,2016-06-16 06:49:32,link,43,50,8,101
95926963131,Hear quotes from the PEOPLE archives—read by People's List cohost Jerry O'Connell.,2016-06-17 20:12:07,video,91,29,41,161
25902406772,We're pitting our Top 2 head-to-head.,2016-06-21 14:09:55,link,73,82,4,159
86680728811,"Even if your pet turtle is not teenaged, a mutant, and living in a sewer hideout, it may still be dangerous: There were 15 multi-state salmonella outbreaks linked to pet turtles between 2006 and 2014, according to a new CDC report.",2016-06-15 17:11:16,link,102,78,29,209
52150999700,Channing Tatum is taking his talents to the small screen for a Miami Vice-inspired series! 😄 👊🏼,2016-06-22 16:33:45,link,179,89,23,291
10606591490,Tom Hanks made quite an impact on Allison Williams.,2016-06-23 20:30:49,link,4,61,6,71
95926963131,Queen Elizabeth II spent some time with David Beckham—and her reaction is all of us. (via People Royals),2016-06-23 22:42:02,link,24,45,23,92
52150999700,"15 years ago today, the first Fast & Furious movie raced into our lives.👌🏼",2016-06-22 16:12:45,link,167,49,20,236
112638779551,This F1 crew tied a world record by changing four tires in 1.92 seconds,2016-06-22 17:58:35,link,93,49,24,166
25902406772,"Lefty spinning running hook thingy off glass And 1???

Kyrie Irving is the king of circus shots.",2016-06-19 21:12:35,link,69,70,43,182
7245371700,"Justin Timberlake has always been a Dad. 

Here's proof that we've just been embarrassingly slow to notice.",2016-06-19 20:37:07,link,22,45,11,78
95926963131,"Authorities continue to search for the young boy, who is now presumed to be dead.",2016-06-15 14:18:02,link,139,6,4,149
86680728811,"After taking her little one to kindergarten orientation, Haley Fulop didn't feel the surge of sadness she had expected. ""I thought I'd be a mess, but I wasn't.""",2016-06-17 05:30:22,link,59,35,19,113
95926963131,Former Vanderbilt University football player Brandon Vandenburg has been found guilty. (via People True Crime),2016-06-19 09:42:18,link,133,30,12,175
86680728811,"Michael Linnington will take the helm of the Wounded Warrior Project, a nonprofit that cares for wounded troops.",2016-06-17 01:02:11,link,113,22,28,163
10606591490,Are you getting enough of this nutrient in your diet?,2016-06-22 23:00:23,link,8,14,19,41
112638779551,"Summer is here and this dude's pool dunk is the greatest!

Andy Nesbitt for @TheBuzzer",2016-06-21 14:17:48,video,143,4,29,176
112638779551,The Baltimore Orioles just keep trading away talent and winning anyway. Their GM opened up to Ken Rosenthal about his strategy.,2016-06-23 21:03:18,link,161,22,39,222
112638779551,Atlanta Braves first baseman Freddie Freeman pulled off a rare feat Wednesday.,2016-06-15 23:17:03,link,53,73,18,144
112638779551,Steve Smith is back with the Baltimore Ravens until he gets an NFL milestone and not a play more.,2016-06-17 14:20:42,link,163,80,20,263
5281959998,See the world through a polar bear's eyes.,2016-06-19 23:55:00,link,175,8,21,204
95926963131,There was a life or death moment that fans did not see on James Corden' Carpool Karaoke with the Red Hot Chili Peppers!,2016-06-16 21:03:09,link,54,10,44,108
112638779551,Draymond Green had some fun at the Cleveland Cavaliers' expense during the Golden State Warriors' championship celebration last year. Will the Cavs respond during their title party?,2016-06-20 00:35:18,link,27,43,14,84
10606591490,Turns out he won't be the only bad guy on the scene.,2016-06-23 13:00:22,link,139,38,30,207
7245371700,"""What I keep hearing in conversations, and what I think many Afghan-Americans believe, is this: Mateen was one of us, but on Sunday, he made it clear that he was not who we are.""",2016-06-16 16:33:08,link,60,11,2,73
5281959998,Breaking News: A Baltimore police officer who drove the van in which Freddie Gray rode before he died was acquitted of all charges.,2016-06-23 10:10:50,link,175,44,38,257
112638779551,"Anything is possible!

Kevin Love finally embraced the 'Lil Kev' alter ego...",2016-06-21 21:21:38,link,143,24,21,188
13652355666,"A Facebook post saying, ""Coming to a gay bar near you,"" appeared to reference Orlando.",2016-06-17 08:10:00,link,62,29,38,129
112638779551,"""It's not right that he's going to be missing one start and I'm going to be missing four games. I mean, this whole problem started with him, so why do I get four and he gets one?"" — Manny Machado on Yordano Ventura",2016-06-18 20:02:19,link,97,92,11,200
25902406772,The NFL could be expanding.,2016-06-16 17:31:41,link,137,39,3,179
86680728811,People around the globe stand in solidarity with Orlando http://abcn.ws/1UGP9nQ,2016-06-18 17:37:33,video,156,15,21,192
7245371700,"Congrats, LeBron James!",2016-06-20 16:58:25,link,44,45,37,126
75932763901,AMAZING!!! Check out this star's impressive 100-pound weight loss!! (via Life & Style Weekly) —> http://bit.ly/28Na1DW,2016-06-18 20:15:00,photo,128,34,33,195
18807449704,"A+ effort, dad.  😂😂",2016-06-18 12:25:00,link,18,47,21,86
10513336322,"""People will talk about sex, politics and religion now, but most people will not tell their friends or family if they have money worries – and the other big taboo is mental health.""",2016-06-20 04:40:00,link,145,88,42,275
112638779551,"""We are looking for dog that's been here a long time and maybe not-so-adoptable"" Baltimore Ravens rookie lineman Ronnie Stanley told staff at the animal shelter.",2016-06-16 08:30:24,link,124,63,33,220
5281959998,"As Britain awaits results, here's a helpful explainer on Brexit.",2016-06-23 22:25:00,link,60,92,28,180
5281959998,Uber's money-grab is seemingly part of an unspoken strategy to mark its territory.,2016-06-20 22:25:00,link,90,98,27,215
95926963131,A search is underway for a missing family who were last seen on a 29-foot sailboat.,2016-06-22 10:40:13,link,43,9,8,60
75932763901,"ALL GROWN UP: This is what Honey Boo Boo looked like four years ago — but today, she looks nothing like her former self! See the pics —>http://bit.ly/1peIeJC",2016-06-19 10:30:00,photo,180,2,37,219
52150999700,The Walking Dead has been shocking and surprising us since Day 1. 😱  (via FanSided),2016-06-24 02:28:00,link,115,17,16,148
10513336322,"""Do the Leave campaigners care about the misuse of public money? No. How do I know? Because they have scarcely mentioned the EU's great bonfire of banknotes. You know, the item that accounts for roughly 40% of the EU budget, or £42bn a year, almost all of which is wasted. You don't know? I rest my case.""",2016-06-22 02:40:00,link,131,36,21,188
25902406772,The Washington Redskins have an interesting history.,2016-06-22 08:38:59,link,25,37,9,71
7245371700,I think we all needed this.,2016-06-18 19:32:13,link,43,75,26,144
86680728811,Chance encounter between  teen and a stranger  has turned into a viral sensation resulting in some major surprises for 15-year-old Demarco Bailey.,2016-06-15 05:30:00,link,51,84,1,136
86680728811,"Sen. John McCain said Thursday Pres. Barack Obama was ""directly responsible"" for the Orlando attack, a comment he later clarified as a criticism of the president's national security policies.",2016-06-16 19:35:25,link,111,2,49,162
13652355666,"Jennifer Pinckney, the wife of slain Rev. Clementa Pinckney, chairs a foundation in honor of the late pastor. In February, she said she was still healing, and doesn't even want to turn on the TV.",2016-06-17 10:52:25,link,160,9,42,211
95926963131,These shocking stories prove just how deadly alligators can be. (via PEOPLE Pets),2016-06-16 04:00:19,link,142,93,38,273
10606591490,"""You can't accomplish anything alone.""",2016-06-16 09:30:40,link,190,55,46,291
86680728811,"Rolls-Royce Motor Cars unveils driverless concept car with ""ample space created by the removal of the chauffeur."" http://abcn.ws/1XZwDho",2016-06-17 12:28:04,link,129,10,50,189
10606591490,1. Straight men think women have an expiration date.,2016-06-18 02:30:11,link,184,16,42,242
112638779551,David Ortiz blasts No. 521 to earn a special spot in the record book,2016-06-17 22:12:51,link,133,76,5,214
75932763901,"Welcome to the world, Rose Elizabeth — and a HUGE congrats to her famous parents (via Life & Style Weekly): http://bit.ly/28JvEeW",2016-06-21 01:00:00,photo,160,85,26,271
112638779551,"Peyton Manning can't wait to watch Eli play ""normal games"" this season.",2016-06-21 10:21:36,link,174,89,15,278
13652355666,The Senate voted down a gun measure that calls for research on the causes of mass shootings and increases funding for the background check system.,2016-06-20 18:20:00,link,181,66,10,257
13652355666,Costco flipped the switch today.,2016-06-20 12:54:00,link,183,96,37,316
7245371700,Could this be Hillary Clinton's greatest advantage during the election?,2016-06-15 01:55:56,link,175,27,10,212
95926963131,Someone is looking for her old six-pack!,2016-06-20 19:52:03,link,126,26,1,153
52150999700,Calling all Nirvana fans. 🙌🏼  🎤,2016-06-19 15:02:00,link,155,97,18,270
25902406772,Not good news the Baltimore Ravens and Trent Richardson.,2016-06-16 21:34:35,link,135,30,42,207
7245371700,"Bars + clubs serve as safe spaces for many marginalized groups — but shouldn't these spaces take specific action to provide bodily safety, too?",2016-06-18 11:50:08,link,38,74,41,153
95926963131,A lot has changed since 2005—but Blake Lively says that one thing has remained.,2016-06-23 23:04:04,link,199,96,11,306
75932763901,IT'S A BOY! Click for more photos — and to find out the unique name his famous daddy gave him! —> http://bit.ly/28JbgvA,2016-06-22 12:57:41,photo,119,32,15,166
95926963131,Hollywood's biggest influencers are calling attention against gun violence.,2016-06-23 07:26:05,link,114,7,45,166
10606591490,"""Are you smart?""",2016-06-21 07:30:10,link,83,85,11,179
112638779551,LeBron James had a message for Cleveland after winning the NBA title.,2016-06-19 22:43:23,link,142,83,7,232
25902406772,"Von Miller wants what he wants, and he is NOT messin' around.",2016-06-16 11:35:30,link,130,52,33,215
18807449704,WHOA.,2016-06-20 21:30:00,link,182,42,48,272
95926963131,It isn't easy being one of the famous Rockettes!,2016-06-17 21:19:22,video,8,30,43,81
7245371700,These are ab-solutely fantastic.,2016-06-16 17:09:06,link,84,36,49,169
10513336322,"Despite countries such as Britain and the United States being five times richer than they were a century ago, we are working longer hours than ever before.

But it doesn't need to be like this – we can cut out 'bullshit' jobs, introduce a basic income and dramatically change the way we live.",2016-06-15 09:40:00,video,173,74,3,250
86680728811,President Barack Obama boards Air Force One for trip to Orlando to meet with victims' families. http://abcn.ws/23e5mqH,2016-06-16 09:53:33,video,138,21,8,167
5281959998,"""I think there are going to be some parties tonight in high school counseling offices and in college admissions offices.""",2016-06-23 20:55:00,link,175,54,27,256
86680728811,San Diego Zoo welcomes an adorable baby koala. Need we say more? http://abcn.ws/1ZS2Ep1,2016-06-15 18:21:39,video,159,55,19,233
18807449704,Pure Game of Thrones fate,2016-06-22 07:04:00,link,200,73,15,288
25902406772,Seattle Seahawks coach Pete Carroll isn't showing Nate Robinson much love.,2016-06-15 11:06:04,link,96,23,6,125
75932763901,Kate Middleton's latest outfit has royal fans FREAKING OUT — wait until you see the photos! (via Closer Weekly) —> http://bit.ly/24R6fET,2016-06-16 00:00:00,photo,8,78,11,97
75932763901,It's OVER for Ben and Lauren — and it's all because of JOJO! Get the shocking details —> http://bit.ly/262oM3A,2016-06-15 18:30:02,photo,43,58,36,137
52150999700,We'd LOVE to see a Disney spinoff with The Little Mermaid's Sebastian!,2016-06-17 23:35:00,link,155,43,11,209
112638779551,Carrlyn Bathe breaks down the 5 biggest NHL games to circle on next season's schedule.,2016-06-21 18:11:49,link,70,6,50,126
25902406772,It's almost time for the U.S. Open Championship.,2016-06-15 10:26:40,link,91,31,1,123
5281959998,Steve King moved to block the Treasury Department's sweeping plan to represent women and civil rights leaders on U.S. currency.,2016-06-21 20:55:47,link,77,54,26,157
52150999700,"A new, older Poison Ivy is going to shake things up on Gotham! 😱",2016-06-22 08:02:15,link,145,73,39,257
86680728811,"In a desert city used to triple-digit temperatures, some hunker down inside and some head to the pool, while others still want to hit Phoenix's many hiking trails. But with temperatures creeping above 115 degrees during a heat wave boiling parts of the Southwest, that decision can have deadly consequences.",2016-06-19 23:25:03,link,66,30,45,141
18807449704,Now this is how to give an email scammer a taste of their own medicine. #Scamalot,2016-06-16 10:33:00,video,126,27,34,187
25902406772,Could Kevin Durant be on his way to the New York Knicks?,2016-06-23 12:39:09,link,116,28,48,192
112638779551,"Dustin Johnson was still in the mix, but Irishman Shane Lowry held the U.S. Open Championship lead after a long Day 3.",2016-06-18 20:25:36,link,100,36,8,144
112638779551,Los Angeles Dodgers first baseman Adrian Gonzalez pulled off a stunning play Wednesday night.,2016-06-23 00:36:02,link,167,35,42,244
7245371700,This would be a refreshing pair in the male-dominated Westeros.,2016-06-17 19:16:01,link,17,47,8,72
7245371700,This would be a refreshing pair in the male-dominated Westeros.,2016-06-19 13:48:04,link,102,82,19,203
25902406772,The UEFA EURO 2016 bracket is set for the Round of 16.,2016-06-22 18:17:57,link,186,92,7,285
25902406772,What a start from Argentina.,2016-06-21 20:29:03,link,188,52,44,284
10513336322,"""We launched a War on Cancer, but for guns, we have only prayers.""",2016-06-17 12:40:00,link,151,15,25,191
112638779551,The second pick of the 1986 NBA Draft was Len Bias. His friend Johnny Dawkins remembers the former Maryland Basketball star who was dead two days later.,2016-06-23 08:54:07,link,58,90,21,169
112638779551,A scary situation occurred after the Cleveland Cavaliers' championship celebration.,2016-06-22 18:01:15,link,191,80,39,310
10606591490,3. You're not learning.,2016-06-20 09:30:13,link,173,75,3,251
10513336322,"""At least 55% of Americans are in favour of stricter gun laws, and it likely that we would have them were it not for the undemocratic structure of the senate.""",2016-06-21 14:30:00,link,72,87,17,176
10513336322,"US and UK studies released for Father's Day paint a mixed picture of modern dadding.

Dads do seem to be more present but we're still a long way from parental equality.",2016-06-19 04:20:00,video,24,41,15,80
112638779551,"Warriors owner Joe Lacob on free agency: ""I set the highest goal and pay them whatever it takes. Great people attract great people.""",2016-06-22 13:56:33,link,114,66,34,214
5281959998,"""A man is in a shop and thinks about stealing an object,"" said a lawyer who has defended several terror suspects. ""What do you do? You put him in jail?""",2016-06-22 06:25:00,link,8,47,25,80
10513336322,"""I can be brought to tears just thinking about my grandmother's paint-peeling garage doors or my grandfather's old twin hairbrushes. I can feel a swell of love that's almost blinding when picturing my mother's cupboard full of Tupperware or lining up my boyfriend's inhalers on the shelf. You would too.""",2016-06-18 03:20:00,link,195,15,45,255
18807449704,Genius,2016-06-17 04:09:46,link,76,77,41,194
25902406772,Quite a scene in Cleveland.,2016-06-22 20:09:17,link,138,50,2,190
75932763901,"""He's very well hung. He's good at what he does, for sure."" Ummm...?! See who made this sex confession about her ex! –> http://bit.ly/1R0pF2g",2016-06-16 21:00:00,photo,54,41,29,124
86680728811,"Whatever happens with Bernie Sanders and the race for president, his supporters say one thing is certain: Their movement will continue. http://abcn.ws/1SbdW1x",2016-06-18 21:17:47,link,8,46,43,97
75932763901,"SO SAD! Jon Gosselin made a troubling revelation about his ex-wife, Kate Gosselin — and we can't imagine how their children will react after hearing this: http://bit.ly/28QlnNW",2016-06-23 20:30:00,photo,132,24,23,179
10606591490,McCain says Obama has allowed the growth of ISIS.,2016-06-16 23:00:24,link,147,62,17,226
18807449704,"Please don't be true, Game of Thrones. Please don't be true.",2016-06-20 11:38:02,link,102,47,50,199
7245371700,"After the last Game of Thrones episode, how could I NOT have these questions?",2016-06-21 11:25:14,link,8,66,48,122
52150999700,Rejoice! Shrek's future looks bright.,2016-06-15 07:33:00,link,56,9,37,102
5281959998,"A juror in the Stanford rape case said he was ""absolutely shocked and appalled"" by the judge's sentence. The judge was later removed from a later sexual assault case.",2016-06-15 15:55:00,link,190,92,43,325
13652355666,"""People say these awful things potentially to a three-year-old little girl. It's alarming and kind of sad.""",2016-06-21 06:41:00,link,63,14,49,126
52150999700,The Game of Thrones crew spent nearly a MONTH filming just this one epic battle. 😱,2016-06-19 16:32:00,link,72,15,19,106
18807449704,You're never too old or too royal for a proper scolding.,2016-06-17 09:00:00,link,124,96,11,231
7245371700,She hasn't taken a day off in a year?,2016-06-23 10:09:40,link,11,4,22,37
10606591490,Amazing.,2016-06-17 05:30:21,link,93,6,31,130
10513336322,Are these the best independent bookstores in the world?,2016-06-18 04:20:01,link,26,95,44,165
10606591490,She's even quoted Taylor Swift.,2016-06-23 07:00:32,link,18,80,11,109
112638779551,Dustin Johnson + Driver + Protracer = must-see. #LexusRCF #USOpen,2016-06-17 17:35:41,video,81,49,9,139
95926963131,Kim Kardashian West is finally putting in her two cents about her famously outspoken husband's on-again feud with Taylor Swift.,2016-06-16 11:25:06,link,94,44,40,178
86680728811,"Signs praising Hondo, Texas, as ""God's Country"" are catching heat from a group that advocates for the separation of church and state.",2016-06-22 07:11:31,link,27,21,11,59
86680728811,"""It was wild. I've never been that nervous in my whole life."" http://abcn.ws/1XZWIwR",2016-06-17 20:18:05,link,196,95,11,302
25902406772,There is a hole at Oakmont this week that is playing nearly 700 yards.,2016-06-16 11:06:47,link,160,32,4,196
5281959998,"Breaking News: Iraqi forces entered the center of Falluja, ISIS' longest-held city, as militants abandoned their positions. Civilians fled en masse.",2016-06-17 08:13:39,link,82,57,11,150
86680728811,"As news of Anton Yelchin's untimely death became public, celebrities from Anna Kendrick to LeVar Burton and more took to social media to honor the young actor.  http://abcn.ws/1Y2Uehe",2016-06-19 14:57:34,link,36,5,34,75
18807449704,Utterly heartbreaking,2016-06-22 04:44:39,link,61,93,22,176
52150999700,Here's some good news for The Bachelor fans who miss Ben Higgins! 💕,2016-06-22 10:16:00,link,177,51,42,270
95926963131,"There was a time when Jenna Dewan Tatum  wasn't dancing in the spotlight, but in the shadows of our favorite 90's boy band! (via HelloGiggles)",2016-06-18 02:00:09,link,35,75,23,133
10513336322,"""Though we've often talked about the cancer and what it means, in all our discussions over the past four years I've never been able to say what I really want to say. I've always wanted to say that I love you, and that I'm grateful for everything you've given me.""",2016-06-18 10:40:00,link,33,9,49,91
10606591490,She sent out tweets to all who wished her well on her 90th birthday.,2016-06-22 04:30:26,link,150,62,36,248
13652355666,"All that talk, but will gun laws change? Not likely.",2016-06-16 16:50:00,link,148,95,25,268
7245371700,"What would happen if underground rap battles were a little more woke? 

This video was created in Collaboration with The KEY OF AWESOME/Barely Productions: 
https://www.facebook.com/barelyproductions",2016-06-23 10:30:00,video,146,45,24,215
10606591490,It's the second-largest June opening of all time.,2016-06-20 05:00:04,link,129,41,25,195
95926963131,The gator was just feet from where guests were riding the popular Walt Disney World attraction.,2016-06-18 12:00:15,link,21,4,24,49
112638779551,The party is on in Cleveland.,2016-06-22 09:08:09,link,119,77,8,204
75932763901,SERIOUSLY?! See whose man got a little TOO HANDSY on the red carpet! –> http://bit.ly/1YcPOme,2016-06-22 14:04:49,photo,130,13,2,145
25902406772,Jamal Murray will be heading to the Denver Nuggets.,2016-06-23 19:49:11,link,144,16,1,161
86680728811,"Man with cerebral palsy to compete with his father in the IRONMAN World Championships - a 140.6-mile swimming, cycling and running journey.",2016-06-20 15:53:49,link,35,80,49,164
10513336322,"""I wish you'd just 'snap out of it' but, of course, I know that's not how it works. So I'll just keep helping you to get up every time you fall down, and I'll keep hugging you and telling you, 'It's fine, we understand,' when really we can never know what it's like.""",2016-06-18 05:20:00,link,76,61,23,160
112638779551,"Sergio Garcia made birdie, then helped a bird.",2016-06-19 16:37:51,link,108,86,37,231
86680728811,Trial of van driver charged with second-degree depraved-heart murder in the death of Freddie Gray has ended. The judge will render his verdict on Thursday.,2016-06-20 19:54:02,link,83,11,9,103
5281959998,"The post-Stonewall, pre-AIDS '70s was a singular time in gay history.",2016-06-23 08:25:00,link,130,72,21,223
5281959998,"The medical examiner overseeing the Orlando shooting said the scene at Pulse nightclub was ""like time just stopped.""",2016-06-15 14:10:00,link,40,77,31,148
7245371700,Appropriate casting choice considering he was also in the OG Power Rangers...,2016-06-22 09:13:16,link,189,71,6,266
86680728811,"'Strawberry moon' lights up the sky, syncing with the summer solstice for the first time in decades. http://abcn.ws/28LfR1f",2016-06-21 09:10:28,photo,168,49,45,262
10606591490,Never be at a loss for words again.,2016-06-18 00:30:22,link,105,71,9,185
10606591490,Christina Grimmie was a Zelda superfan.,2016-06-21 15:30:06,link,14,72,15,101
95926963131,Johnny Depp's daughter Lily Rose Melody Depp visits him on private island in the Bahamas. (via People Video),2016-06-23 19:46:00,video,170,67,18,255
5281959998,"For a brief moment in the summer of 1982, a goal for Northern Ireland united the country's Catholics and Protestants.",2016-06-16 03:55:00,link,196,76,7,279
112638779551,This was a close call,2016-06-22 09:39:52,link,145,35,1,181
95926963131,The details of the horrific morning Michael Jackson died—and how his kids witnessed it.,2016-06-22 14:21:07,link,81,62,16,159
10513336322,"Boris Johnson: ""This is far more important than any individual political career.""",2016-06-21 07:40:00,link,59,14,27,100
25902406772,The UEFA Euro 2016 is LIT.,2016-06-16 16:40:48,link,68,54,28,150
25902406772,Johnny Manziel in the locker room was .....,2016-06-15 18:48:09,link,190,37,50,277
112638779551,"Watch the Miami Marlins' Ichiro Suzuki notch his 4,257th hit against the San Diego Padres.",2016-06-15 18:10:37,link,69,56,18,143
52150999700,Can we PLEASE see a The Little Mermaid spin-off for Sebastian?! 🙏🏼,2016-06-20 06:29:00,link,122,46,20,188
86680728811,"Fatal alligator attacks are rare, but here's what you should do if you encounter one in the wild: http://abcn.ws/1XXnENF",2016-06-15 12:26:12,link,32,68,2,102
10606591490,Some fans are hoping it will feature footage of Taylor Swift.,2016-06-23 13:30:33,link,105,36,27,168
13652355666,Live (almost) like the Jetsons.,2016-06-18 10:32:00,link,188,69,23,280
13652355666,"First, stay away from produce that looks too pretty. http://bit.ly/1YkaYz0",2016-06-18 07:05:00,video,89,81,5,175
10606591490,"Nick Jonas: ""I work with people who are creative, and if photo shoots are sexual in some way or have a sexy edge, it's just fun to get in a room and create.""",2016-06-15 16:30:25,link,85,65,24,174
86680728811,"It's hot enough to cook an egg on a manhole cover in Gilbert, Arizona. http://abcn.ws/28K8r10",2016-06-20 19:08:43,video,43,73,11,127
112638779551,"Rob Perez explores NBA Draft day trades that should, would, and could happen tonight:

http://www.foxsports.com/nba/story/nba-draft-day-trades-that-should-would-and-could-happen-062316",2016-06-23 13:41:04,link,147,67,3,217
5281959998,Exploring the twists that Kacey Musgraves and the Dixie Chicks provide to country music.,2016-06-16 18:25:00,link,8,66,24,98
10513336322,"""The Gogglesprogs are excellent people. They are desperate for Tom and Megan's date to work out, are full of compassion for refugees, and will often find the good in something that doesn't obviously merit it.""",2016-06-19 01:20:01,link,126,77,3,206
5281959998,"American Psycho - The Musical met a gruesome end. 
Tuck Everlasting was not immortal. 
Bright Star: A New Musical ran out of fuel. 
And Disaster - On Broadway proved to be — well, you can finish that one yourself.",2016-06-22 22:55:00,link,75,49,5,129
25902406772,CLEVELAND. JUST. WITNESSED.,2016-06-19 21:42:11,photo,32,83,25,140
52150999700,Frank Ocean's deeply personal post included LGBT pride and hope for the future amidst tragedy.,2016-06-21 07:45:00,link,95,39,26,160
52150999700,Mark your calendars for these exciting NBC shows! 📺,2016-06-15 13:56:07,link,49,14,16,79
25902406772,Indianapolis Colts punter Pat McAfee gets sweet revenge.,2016-06-15 15:22:50,link,59,13,48,120
18807449704,STRESSING!,2016-06-17 20:00:00,link,44,14,44,102
95926963131,"Alerted by her son's screams, the mother ran outside and saw the lion on her son.",2016-06-18 10:00:10,link,172,20,31,223
7245371700,Avicii named his new album?!,2016-06-16 22:23:41,link,196,69,5,270
7245371700,"""If you're following the line of Mitski Miyawaki's career, you're tracing the unmistakable arc of a rock star.""",2016-06-19 18:41:04,link,20,82,2,104
18807449704,It's true: Rick Astley really is never gonna give us up.,2016-06-19 12:40:00,link,31,6,44,81
5281959998,The great-grandson of Maria and Georg von Trapp marries a kindred spirit.,2016-06-17 20:30:12,link,123,48,26,197
7245371700,"In this special podcast, you'll hear LGBTQ people from Orlando and other places in America tell their stories.",2016-06-17 12:44:26,link,165,53,48,266
95926963131,"Before The Bachelorette faced a few brutal goodbyes, she received an unexpected ""I love you.""",2016-06-21 10:03:05,link,97,88,29,214
7245371700,"""I thought that was the only way to make the hate directed toward me disappear.""",2016-06-22 20:46:34,link,123,20,36,179
52150999700,Our favorite Orange Is the New Black characters have come a long way to get to Litchfield.,2016-06-18 14:31:00,link,48,2,35,85
95926963131,We can't handle how tiny they are! 😍 (via PEOPLE Pets),2016-06-23 21:58:05,link,130,100,1,231
7245371700,Are you crazy about Dasey?,2016-06-17 16:32:00,link,38,62,3,103
18807449704,Just FYI.,2016-06-23 12:29:57,link,98,11,25,134
10606591490,So brave.,2016-06-19 01:30:05,link,180,100,17,297
13652355666,"BREAKING: Reinhold Hanning, a former guard at Auschwitz, was convicted of complicity in the murder of 170,000 people at the Nazi death camp.",2016-06-17 07:59:12,link,59,83,13,155
112638779551,Michael Bisping pulls no punches when asked about fighting Conor McGregor in the UFC,2016-06-22 11:11:53,link,6,60,41,107
5281959998,The first few days of Costco's new alliance with Visa has turned into a customer service fiasco.,2016-06-23 19:55:00,link,129,58,8,195
10513336322,"The polls have closed in Britain's referendum on EU membership, with a survey suggesting a bitterly close fight and Ukip leader Nigel Farage saying it ""looks like Remain will edge it"".",2016-06-23 16:40:00,link,70,6,20,96
112638779551,"Marshawn Lynch not only shared a suite with Draymond Green during Game 5, but shared life advice as well...

Here's the advice Marshawn gave the Golden State Warriors star during his suspension....",2016-06-16 11:07:47,link,46,62,15,123
86680728811,"To all the fathers out there, we hope you have a very happy Father's Day!",2016-06-19 07:00:00,photo,174,38,18,230
52150999700,Cameron Dallas is about to have A LOT more than a few seconds to share his content.,2016-06-22 19:58:00,link,197,75,21,293
7245371700,"As much as I would LOVE to sing ""Wannabe"" at a The Spice Girls reunion show, here's why we should probably all give up on this idea...",2016-06-19 01:08:28,link,1,61,14,76
52150999700,Get excited for the even MORE profanity-laced version of Negan's wild The Walking Dead entrance! 😱,2016-06-21 14:21:00,link,90,36,12,138
86680728811,"Thousands of firefighters in their dress blues stood at attention and saluted Friday as a flag-draped casket passed carrying two tiny vials of blood, the only known remains of a comrade who died in the Sept. 11 attacks.",2016-06-18 02:47:16,link,194,28,12,234
86680728811,NASA's Kepler discovers what is believed to be the youngest fully-formed exoplanet ever detected - estimated to be 5 to 10 million years old.,2016-06-21 12:43:08,link,56,3,39,98
10513336322,"""The only way I could really talk about our brother's suicide was by including him in this poem that is basically a long list of famous people who killed themselves. Because Darin was such a famous person in my mind and my heart.""",2016-06-19 09:20:00,link,82,99,45,226
75932763901,Fans are FREAKING OUT over this photo of Kendra Wilkinson and Hank Baskett — and it's because of the exciting message in the caption! Read it here: http://bit.ly/1ZOc30I,2016-06-18 10:00:00,photo,171,1,25,197
18807449704,"Bow down, Jon Snow",2016-06-20 07:37:31,link,36,83,25,144
112638779551,"UFC star Sage Northcutt can squat on a medicine ball like it's nothing!

Rachel Bonnetta for @TheBuzzer",2016-06-23 12:46:43,video,51,47,14,112
112638779551,The Golden State Warriors will be at full strength -- but a little lighter financially -- against the Cleveland Cavaliers on Sunday.,2016-06-17 10:50:03,link,104,92,22,218
7245371700,"If you think America's problem with gun control stops at mass shootings, think again.",2016-06-17 13:31:57,video,182,99,25,306
18807449704,OMG. 😂 😂 😂,2016-06-19 11:50:00,link,144,47,10,201
86680728811,"The Pixar sequel far-surpassed its already Ocean-sized expectations to take in $136.2 million in North American theaters, making it the highest-grossing animated debut of all time: http://abcn.ws/21tQfYK",2016-06-19 16:11:21,link,25,58,46,129
95926963131,The star of the upcoming survivor thriller The Shallows talks putting her family first. (via People Babies),2016-06-15 13:12:03,link,188,46,16,250
112638779551,"The New York Knicks have a new star in Derrick Rose....

And not only does Rose's former coach John Calipari think he'll be really good in New York, Calipari thinks Rose will return to his MVP-caliber form....",2016-06-23 11:53:21,link,2,98,35,135
52150999700,Led Zeppelin Official is officially in the clear! 🙌,2016-06-23 12:27:54,link,46,43,40,129
25902406772,Not all heroes wear capes.,2016-06-20 12:52:44,link,44,88,22,154
10606591490,Who do you think is most influential?,2016-06-23 05:00:23,link,74,51,6,131
25902406772,Choosing Alabama Football's Mt. Rushmore was an easy feat.,2016-06-22 10:52:48,link,63,13,29,105
112638779551,Are you a big enough LeBron James fan to drop $850 on a bobblehead?,2016-06-21 10:27:49,link,142,37,8,187
25902406772,The Pittsburgh Pirates can thank their pitching prospects.,2016-06-15 10:13:32,link,91,34,23,148
52150999700,The Like Crazy director wrote a moving and powerful statement honoring the Star Trek actor.,2016-06-19 18:47:25,link,179,2,22,203
52150999700,The Real Housewives of Orange County ladies are back and better than EVER. 🍊,2016-06-20 19:30:00,link,20,89,3,112
10606591490,"""I am such a happy Chewbacca""",2016-06-19 15:01:21,link,115,74,37,226
18807449704,Celebrities shower LeBron James with praise after historic NBA Finals win.,2016-06-20 15:42:07,video,20,33,40,93
95926963131,"Attrell Cordes, known to fans of R&B group PM Dawn as ""Prince Be,"" has died at age 46.",2016-06-17 18:01:15,link,177,75,1,253
95926963131,Many athletes are worried about the possibility of contracting Zika virus—and are taking precautionary measures.,2016-06-17 06:00:18,link,130,3,44,177
5281959998,"Whether it's breakfast or breakfast for dinner, make the perfect pancakes.",2016-06-15 16:55:01,link,21,13,33,67
5281959998,"Executives, bankers and bureaucrats are trying to plan for potential market panic.",2016-06-15 04:58:42,link,65,79,30,174
18807449704,Thanks Dad!,2016-06-16 10:09:17,link,179,18,36,233
18807449704,Asian-Americans refuse to be made invisible.,2016-06-19 10:45:00,link,169,13,35,217
13652355666,"""At the request of the FBI, no further information is available regarding the shooter's autopsy report, who the body was released to and when the body was released.""",2016-06-21 02:20:00,link,114,6,34,154
112638779551,An unintentional magic trick.,2016-06-22 06:34:01,link,43,25,27,95
10606591490,"""We didn't have anything on the plane to help him.""",2016-06-22 07:00:46,link,34,88,9,131
86680728811,Time-lapse video shows changes to Quicken Loans Arena in Cleveland after the end of Game 6 ahead of next month's Republican convention. http://abcn.ws/28K7jKA,2016-06-20 21:24:21,video,126,38,44,208
75932763901,CONGRATS!! She's PREGNANT with their first child together! Find out who —> http://bit.ly/1UHvLtx,2016-06-22 03:30:00,photo,35,26,17,78
7245371700,6-year-old Jennette McCurdy was more popular than Regina George.,2016-06-22 14:36:24,link,194,82,3,279
112638779551,"Bubba Watson pulled off a great trick shot, which also happens to be the easiest way to play out of the rough.",2016-06-15 08:08:30,link,157,29,30,216
25902406772,LeBron James crushed the Cleveland Cavaliers parade.,2016-06-23 10:05:03,link,79,69,41,189
52150999700,No more Mr. Nice Guy for The Late Show with Stephen Colbert—it's time to get real.,2016-06-22 08:55:01,link,72,91,43,206
10513336322,"A year after the bombings of two US embassies in east Africa in 1998, Osama bin Laden, the founder and leader of al-Qaida, explained what he saw as his primary task.

""Our job is to instigate.""",2016-06-16 09:40:01,link,20,90,17,127
7245371700,They told DJ Khaled he couldn't tour with Beyoncé.,2016-06-15 19:56:55,link,9,79,23,111
25902406772,James Harden wants a reunion with Kevin Durant...in Houston.,2016-06-23 14:55:31,link,82,65,27,174
18807449704,So THAT'S why Ghost wasn't in Game of Thrones' 'Battle of the Bastards.',2016-06-22 10:26:06,link,143,38,29,210
95926963131,"Jamie Lynn Spears is getting back to work in her singing career—but her job, first and foremost, is as a mother.",2016-06-23 09:30:20,link,90,8,38,136
25902406772,"""I'm nothing without all of y'all.""",2016-06-22 18:00:04,photo,53,93,22,168
75932763901,"Fans have gone WILD over Kylie Jenner's recent Instagram post — and when you see what it reveals, you'll understand why it has over 1 MILLION likes! –> http://bit.ly/1rXTlJo",2016-06-18 14:15:00,photo,160,76,44,280
10513336322,Could looking at your smartphone while lying in bed at night wreak havoc on your vision?,2016-06-23 05:00:00,link,17,25,17,59
112638779551,Dealing with temptation at Oakmont. Ken Brown walks you through the difficulties of the 17th.,2016-06-16 14:55:19,video,191,73,20,284
10513336322,"""Starting with the most distant of dads, Darth Vader.""",2016-06-18 14:00:00,link,88,50,50,188
10513336322,"It would be easy to say that Massimo Bottura became the first Italian to win the top spot of the World's 50 Best Restaurants this week because he is a famous master chef of a cuisine that is adored, and that Italy deserved the honour. But that would be too simple...",2016-06-17 10:00:00,link,161,33,1,195
18807449704,"Yes, it's actually there.",2016-06-22 10:00:01,link,182,35,35,252
10513336322,Ribs for your pleasure.,2016-06-20 08:00:01,link,126,9,20,155
13652355666,This isn't his first run-in with the law.,2016-06-17 04:05:00,link,5,80,44,129
5281959998,This meteorite is unlike any ever before found on Earth.,2016-06-16 20:01:00,link,39,30,15,84
18807449704,This small design change could make a big difference.,2016-06-15 14:20:41,link,66,6,34,106
52150999700,An alum from The Originals is joining the superhero ranks of DC's Legends of Tomorrow! 🔥 👊🏼,2016-06-23 16:34:57,link,51,46,19,116
18807449704,A duck who lost both of it's feet to frostbite is finally able to walk again... after his rescuer got him a pair of 3-D printed feet.,2016-06-22 11:59:50,video,18,3,6,27
13652355666,"""Due to the partially indecipherable handwriting, the threatening language, the profanity, and the nature of the filings — some of which were submitted on what appears to be toilet paper — the court has been unable to fully discern (his) allegations.""",2016-06-18 00:50:01,link,105,59,24,188
10513336322,"Scientists have announced the first extinction of a species due to climate change caused by humans.

One in six species now faces the same fate, so some think this is just the tip of the iceberg.",2016-06-15 09:00:00,video,97,65,9,171
7245371700,"Girl, spill the gossip.",2016-06-22 09:38:59,link,166,5,9,180
75932763901,She POPPED!,2016-06-22 10:00:00,link,145,84,44,273
5281959998,Donald J. Trump has less money at this point in the election than any other recent major-party presidential candidate.,2016-06-21 16:25:57,link,109,2,16,127
112638779551,There's only one way for LeBron James to leave the Cleveland Cavaliers -- on top.,2016-06-21 06:39:29,link,152,30,27,209
5281959998,Want to become an animal masseuse in Arizona? You may need a license.,2016-06-17 15:27:39,link,55,44,2,101
86680728811,"Singer Meat Loaf collapsed on stage while performing in Edmonton and was taken to a hospital in unknown condition, according to Canadian news reports.",2016-06-17 01:03:57,link,151,66,24,241
52150999700,Justin Timberlake's tribute to the late Star Trek actor is emotional. ❤️,2016-06-20 17:11:00,link,141,88,5,234
25902406772,"It's NBA Draft time. Join Rip Hamilton and Raja Bell for instant analysis of every pick.

Comment with your questions to have them answered by our #squad.",2016-06-23 20:17:26,video,7,44,23,74
18807449704,This is better than The Notebook 😭,2016-06-15 06:04:04,link,155,4,26,185
112638779551,"This is not your typical player unveiling photo.

Nicole Dabeau for @TheBuzzer.",2016-06-15 19:39:04,video,37,34,12,83
86680728811,"18-year-old woman dies in Ohio after being infected by Naegleria fowleri, commonly called a ""brain-eating ameoba."" There have been just 37 cases in the U.S. since 2006.",2016-06-22 11:20:32,link,82,49,35,166
7245371700,I've always been wondering about this.,2016-06-18 04:42:19,link,74,83,9,166
5281959998,"Donald J. Trump offered his usual stew of fear, jingoism and hatred after the attacks in Orlando. Read on in The New York Times Opinion Section.",2016-06-15 05:55:01,link,162,8,37,207
25902406772,The Classic has a home for 2016.,2016-06-22 21:43:26,link,27,75,25,127
112638779551,"Cristiane ""Cyborg"" Santos calls out UFC champ Miesha Tate",2016-06-23 18:09:40,link,33,58,37,128
112638779551,"""Our fans deserve it. This was for them."" 

LeBron James gives a shoutout to Cleveland.",2016-06-19 23:51:40,video,11,99,9,119
75932763901,"Just months after welcoming Baby No. 2, Michael Bublé has received some very unfortunate news. Get the sad details (via Closer Weekly) —> http://bit.ly/1Vb7TAt",2016-06-23 05:00:00,photo,173,51,34,258
10606591490,"Amber Rose: ""With Taylor Swift it's, you know what, I'm done with Calvin Harris and it didn't work out, so on to the next.""",2016-06-20 11:00:12,link,123,83,24,230
95926963131,Mommy blogger begs  readers to stop blaming and shaming other parents in the wake of unthinkable tragic accidents.,2016-06-17 14:20:06,link,54,52,23,129
52150999700,Someone made a HUGE comeback this week on Wayward Pines. 😱,2016-06-15 21:03:57,link,61,3,39,103
5281959998,"You've likely seen it at the mall: it's longer-in-back, slightly–shorter-in-front. It's ""mom hair."" (via The New York Times Styles)",2016-06-21 14:25:00,link,126,68,19,213
75932763901,Oh BABY! See who showed off her HUGE baby bump in this itty bitty bikini! –> http://bit.ly/28J8owp,2016-06-20 19:00:00,photo,175,80,30,285
112638779551,"From eye-opening trades to unusual picks, there wasn't a lack of storylines from Thursday's draft.",2016-06-23 22:28:05,link,13,76,2,91
18807449704,ABOUT TIME. 🙌 🙌,2016-06-18 16:15:00,link,54,88,36,178
86680728811,"Father of Orlando gunman says his son was buried at a Florida cemetery this week, ABC News' affiliate WPBF 25 News reports. http://abcn.ws/28PzEgz",2016-06-21 21:21:30,link,183,45,41,269
18807449704,Not the Vegemite! 😱,2016-06-24 00:00:00,link,11,71,26,108
25902406772,Bret Bielema seems to have a ton of confidence in the state of things with Arkansas football.,2016-06-20 11:53:22,link,59,6,1,66
25902406772,LeBron James isn't too happy about the DPOY snubs.,2016-06-18 20:36:40,link,5,75,20,100
112638779551,A dejected Stephen Curry talks about Kyrie Irving's incredible 3 pointer that decided the Golden State Warriors fate.,2016-06-20 00:09:00,video,171,30,22,223
10513336322,"Tim Peake: ""When it comes to using the loo, gravity is your friend.""",2016-06-21 10:40:00,link,26,23,9,58
25902406772,Crazy.,2016-06-19 21:57:14,photo,17,88,30,135
112638779551,The 1986 NBA Draft saw Duke Men's Basketball's Johnny Dawkins and Maryland Basketball's Len Bias selected in the first round. The former Blue Devil star remembers his friend and foe who died two days later.,2016-06-16 14:14:53,link,38,2,38,78
25902406772,U.S. Soccer has a legit chance to make history at Copa América Centenario 2016.,2016-06-15 09:04:32,link,15,71,11,97
5281959998,Breaking News: Russia's track and field team has been barred from the Rio Olympic Games because of a far-reaching doping conspiracy.,2016-06-17 10:04:14,link,112,57,29,198
13652355666,"#Enough, Senator Chris Murphy tweeted.",2016-06-15 14:10:00,link,93,39,35,167
112638779551,Andrew Landry holds a one-shot lead before rain suspended play during the first round of the U.S. Open.,2016-06-16 16:07:37,link,132,35,18,185
95926963131,This Facebook post went viral just three days after the deadliest mass shooting in U.S. history.,2016-06-22 09:56:08,link,191,11,11,213
52150999700,Scott Speedman gets real about playing brother Baz on Animal Kingdom TNT.,2016-06-15 04:17:00,link,112,28,43,183
10606591490,5. Almonds.,2016-06-23 06:00:53,link,34,46,21,101
13652355666,"""Although I am not transitioning, I have and always will be supportive of those who are going through their journey.""",2016-06-15 19:27:00,link,31,40,42,113
18807449704,May we all be this happy.,2016-06-20 14:00:00,link,75,36,6,117
112638779551,The former football coach had been accusing the university of wrongful termination.,2016-06-17 13:52:54,link,134,22,1,157
86680728811,"The FBI said that there wasn't enough information to conduct a ""meaningful investigative follow up"" on an individual who employees of a Florida gun store thought was ""suspicious"" and later believed they recognized as Orlando nightclub shooter Omar Mateen: http://abcn.ws/1QcpRC9",2016-06-17 19:11:24,link,98,29,8,135
10513336322,"""It's really important that disabled children are able to see representations of people who look a bit like them in the media so that they can see all the different things that they have the ability to do.""",2016-06-19 09:00:01,link,81,62,26,169
10606591490,The key to Blake Lively and Ryan Reynolds' romance.,2016-06-15 16:01:12,link,102,31,30,163
75932763901,This is NOT what we were expecting... 😳,2016-06-17 14:00:00,link,63,67,50,180
75932763901,Cha-Ching! You'll be SHOCKED when you see how much each 'Friends' star is worth today (via Closer Weekly) —> http://bit.ly/1UvWlaq,2016-06-16 07:15:00,photo,141,44,40,225
5281959998,"The unusually fierce tornado catapulted cars, ginkgo trees and cellphone towers through the air. Authorities are still trying to make sense of the high death toll.",2016-06-23 12:25:00,link,64,58,45,167
95926963131,A day visiting a North Carolina water park turned fatal for an Ohio teen.,2016-06-22 16:55:04,link,90,63,2,155
86680728811,Somber vigils held in Puerto Rico: Authorities say nearly half of those killed at the Pulse nightclub in Orlando had ties to the U.S. territory.,2016-06-15 00:19:49,link,196,78,13,287
75932763901,TWINS! Teen Mom 2 star Chelsea Houska's daughter is becoming her SPITTING IMAGE — and this photo proves it: http://bit.ly/28TljOF,2016-06-24 14:00:00,photo,33,20,14,67
112638779551,"""Best Father's Day ever!"" - Dustin Johnson is the U.S. Open Championship winner. #USOpen",2016-06-19 19:41:41,video,91,4,41,136
10513336322,"What did you the think of the latest Game of Thrones episode?

(Spoiler alert).",2016-06-21 11:00:01,link,4,100,41,145
52150999700,Xena: Warrior Princess' journey from heroine to feminist icon is seriously inspiring.,2016-06-18 07:15:00,link,192,36,8,236
52150999700,DC's Legends of Tomorrow includes one of the only LGBT superheroes on screen.,2016-06-20 22:14:00,link,54,18,44,116
95926963131,This Real Housewives of New York City star isn't letting her divorce bring her down.,2016-06-17 15:04:03,link,10,29,16,55
95926963131,Prince William isn't too old for a scolding! 😂 (via People Royals),2016-06-16 17:39:06,link,32,69,35,136
5281959998,"""It's not just about counting the drinks — it's about the number where each of us becomes untrustworthy.""

Read on in The New York Times Opinion Section.",2016-06-19 23:25:00,link,78,86,47,211
52150999700,Aaron Paul had a lot riding on the Breaking Bad pilot.,2016-06-18 13:52:00,link,133,74,1,208
112638779551,The WWE roster will be split on the first live episode of SmackDown. Who should be the No. 1 pick?,2016-06-20 09:59:16,link,32,67,47,146
75932763901,"PLASTIC SURGERY? The Situation was known for his good looks back in his Jersey Shore days, but his latest photo looks like a totally different person! —> http://bit.ly/1VkkYYM",2016-06-19 05:15:00,photo,26,15,31,72
75932763901,"BACHELOR BOMBSHELL: After confessing his remaining feelings for JoJo Fletcher, Ben Higgins and Lauren Bushnell make an announcement no one saw coming! —> http://bit.ly/28UJETj",2016-06-22 14:35:59,photo,130,47,2,179
86680728811,"Hillary Clinton and her Democratic allies have invested at least $41 million in commercials in crucial states such as Ohio, Florida and Nevada over the next six weeks, while Donald J. Trump has made few preparations for contending with that sort of well-oiled political machine: http://abcn.ws/1Y1fYtY",2016-06-18 20:55:04,link,59,62,44,165
112638779551,With the first pick in the 2016 NBA Draft the Philadelphia 76ers select Ben Simmons.,2016-06-23 18:37:50,photo,81,13,17,111
75932763901,"SERIOUSLY?! This pic of Chrissy Teigen shows her true personality – when you see the full pic, you'll understand why it has some fans MAD –> http://bit.ly/1UnKav3",2016-06-20 08:30:00,photo,85,16,24,125
25902406772,The Carolina Panthers have a sense of humor.,2016-06-17 18:09:29,link,31,29,42,102
25902406772,Former Chicago Bears star Martellus Bennett doesn't like to talk about his ex's.,2016-06-15 13:02:34,link,91,57,31,179
10513336322,"Fracking wastewater could end up in the sea, according to emails sent by Ineos to a local resident.",2016-06-16 00:30:00,link,87,3,30,120
10513336322,"Frank Field: ""People who already have wealth, own a home of their own and have a secure job may not worry about immigration, but Labour's heartland supporters do worry about it.""",2016-06-15 01:00:01,link,193,67,6,266
25902406772,Klay Thompson knows the Golden State Warriors let one get away.,2016-06-20 21:42:32,link,15,92,45,152
13652355666,Maybe it's time to stop calling Tesla an automaker.,2016-06-21 23:10:00,link,27,20,2,49
7245371700,Real World: Seattle set the bar high.,2016-06-18 20:28:06,link,44,33,7,84
7245371700,Which of these pieces resonated with you the most?,2016-06-17 21:24:59,link,125,95,7,227
5281959998,"Nearly ¼ of preschoolers in America have tooth decay. Catherine Saint Louis is talking with Dr. Eyal Simchi about preventing cavities in children, and a pain-free alternative to drilling and filling.",2016-06-20 12:29:44,video,111,87,6,204
25902406772,Rory McIlroy didn't hit many drivers on Thursday and Friday.,2016-06-17 10:15:26,link,195,79,43,317
112638779551,Bryce Harper must have been extremely pleased when Joe Blanton entered the game for the Los Angeles Dodgers.,2016-06-21 08:19:22,link,28,35,35,98
86680728811,Man who was stopped near the Holland Tunnel with an arsenal of guns allegedly told police he was going to NYC to rescue a teenage girl he believed was in danger from drugs.,2016-06-22 13:46:52,link,76,63,8,147
7245371700,I'm wigging out over Bella's new look.,2016-06-21 08:33:18,link,38,46,48,132
10606591490,Devoted hot yogis swear by it—but are the benefits all they're cracked up to be?,2016-06-21 08:30:05,link,84,35,22,141
52150999700,The show's over—HBO has officially pulled the plug on Vinyl.,2016-06-22 12:46:04,link,19,1,22,42
10606591490,"""Modern-day slavery comes in many different shapes and forms.""",2016-06-20 01:00:09,link,104,81,17,202
25902406772,The U.S. Open at Oakmont got messy on Sunday and there's a way for it to not happen again.,2016-06-22 09:59:11,link,58,96,16,170
86680728811,"A fast-moving brush fire that broke out in Santa Barbara County had grown to 1,700 acres as of early Friday. http://abcn.ws/21r0c9g",2016-06-17 15:23:29,link,111,87,40,238
95926963131,Seventy never looked so good!,2016-06-17 10:18:04,link,19,19,36,74
18807449704,Fire rips through California canyons.,2016-06-18 11:45:00,video,198,16,16,230
10513336322,How do you protect one endangered species when it is being eaten by another?,2016-06-22 13:30:00,link,16,87,30,133
10606591490,It goes back to ancient times.,2016-06-17 02:00:28,link,149,9,34,192
7245371700,Talk about being ~stressed out~.,2016-06-22 17:30:11,link,135,96,13,244
7245371700,"Your presence on these apps will be seriously missed, Demi Lovato.",2016-06-21 07:30:53,link,60,33,41,134
7245371700,"Also, he looks EXACTLY the same.",2016-06-15 06:04:48,link,150,76,43,269
25902406772,Just... wow.,2016-06-19 21:59:15,link,31,74,9,114
7245371700,"How could you, OITNB?",2016-06-21 20:16:20,link,162,19,2,183
7245371700,Blake Lively has expensive taste.,2016-06-17 05:53:28,link,90,44,17,151
112638779551,A ceremony in the Amazon ahead of the Rio Olympics went awry.,2016-06-21 17:12:37,link,47,100,48,195
7245371700,"""It feels like my identities are being used against each other.""",2016-06-20 18:55:07,video,7,22,25,54
25902406772,The Chicago Bulls just got a gamer.,2016-06-23 20:12:44,photo,75,16,6,97
10513336322,"""If you do not want to be saying: 'I want my country back' for the rest of your life, my best advice is not sell it out on Thursday.""",2016-06-19 05:00:01,link,124,21,15,160
10513336322,"""Communities that take a stand are increasingly finding themselves in the firing line of companies' private security, state forces and a thriving market for contract killers. For every killing we document, many others go unreported.""",2016-06-21 05:00:00,link,18,58,15,91
7245371700,"""Freedom without safety is no freedom at all, as America has been teaching black people living within its borders for the past 400 years.""",2016-06-21 19:46:46,link,55,68,17,140
10606591490,"Kareem Abdul-Jabbar: ""White faces waving guns is just part of our cultural heritage; brown faces waving guns is an international conspiracy.""",2016-06-15 20:30:10,link,22,61,16,99
112638779551,"""Everything I do is for my family"" An emotional JR Smith thanks his parents after winning the NBA championship. 

This is what it's all about.",2016-06-19 23:47:00,video,109,59,33,201
25902406772,Leisl Tesch had her bicycle stolen by an armed man.,2016-06-22 09:45:34,link,34,67,44,145
18807449704,Martha Stewart had absolutely no clue who she met.,2016-06-22 20:37:29,link,93,31,6,130
13652355666,Legacies. Records. History. It's all on the line right now for Game 7.,2016-06-19 20:40:00,link,46,8,12,66
13652355666,"One of the girls was apparently a ""gift"" from her financially strapped parents.",2016-06-19 10:13:05,link,184,66,14,264
10606591490,Prince William doesn't always get the royal treatment.,2016-06-17 06:30:18,link,64,23,9,96
25902406772,LeBron James doesn't appear to be ballin' for USA Basketball this time around.,2016-06-23 18:06:40,link,92,86,5,183
13652355666,More than half of those surveyed said they would never vote for Trump.,2016-06-15 03:30:00,link,32,33,32,97
7245371700,These memes are ~Loki~ hilarious.,2016-06-16 14:18:10,link,123,92,22,237
13652355666,The United Nations' secretary-general is calling on European nations to provide additional aid to Greece as it struggles to cope with the migrant crisis.,2016-06-18 23:15:06,link,137,35,6,178
95926963131,YouTube star Anna Akana opens up about healing after her sister's suicide—and how Margaret Cho helped. (via People Video),2016-06-20 00:00:00,video,121,39,21,181
86680728811,"Members of Congress recite Stanford University sex assault victim's letter on the floor of the U.S. House of Representatives to ensure it will be documented as part of American history. ""To girls everywhere, I am with you."" http://abcn.ws/1YsRKao",2016-06-16 05:53:45,video,131,20,17,168
10606591490,Priyanka Chopra does not shy away from a pun.,2016-06-21 15:00:27,link,148,23,9,180
75932763901,"CONGRATS! After struggling to conceive, this famous lady is about to be a mom — AGAIN! —> http://bit.ly/28M2iwb",2016-06-22 08:00:00,photo,71,79,45,195
112638779551,"A fan asked Dell Curry for a handshake, but savagely dabbed on him instead.",2016-06-20 08:42:02,link,132,35,17,184
52150999700,Charmed's Shannen Doherty and Holly Marie Combs bond at the opera: http://share.ew.com/w5eQ3Af,2016-06-17 01:45:00,video,58,99,27,184
52150999700,WICKED The Musical is ready to defy gravity on the big screen! 👌🏼,2016-06-16 12:34:49,link,152,74,24,250
75932763901,He walked out on her when she was SEVEN MONTHS PREGNANT to be with another Hollywood actress! See who (via Closer Weekly) —> http://bit.ly/1UfJmZJ,2016-06-23 03:00:00,photo,93,22,41,156
95926963131,PEOPLE has obtained the frantic 911 call after 2-year-old Lane Graves was dragged to his death by an alligator at the Walt Disney World resort.,2016-06-21 05:00:00,video,43,93,9,145
10606591490,David Cameron announced that he will step down.,2016-06-24 03:00:07,link,48,45,18,111
25902406772,Golden State Warriors coach had some interesting postgame quotes.,2016-06-16 23:40:37,photo,106,88,15,209
86680728811,Bounce house swept up by wind during child's birthday party and sent flying into power lines in New York. http://abcn.ws/28Jmcuo,2016-06-20 10:56:29,video,63,88,21,172
13652355666,Plaintiffs say the lattes are too small.,2016-06-21 09:09:00,link,152,67,7,226
10606591490,"Chelsea Clinton said she and her husband were ""overwhelmed with gratitude and love.""",2016-06-19 22:00:12,link,132,90,36,258
25902406772,"Courtside seats for Game 7 cost an arm and a leg*

(*limbs made out of diamonds)",2016-06-19 16:28:58,link,75,99,15,189
75932763901,"While battling with lyme disease, Yolanda Foster makes an unexpected confession that's left fans speechless —> http://bit.ly/1VZCv8k",2016-06-15 21:30:00,photo,191,55,45,291
52150999700,Tom Cruise is officially BACK in action! 👊🏼,2016-06-22 08:18:45,link,102,57,42,201
7245371700,Here are just a few things that are harder to get than an AR-15 assault rifle.,2016-06-17 10:21:27,video,24,44,50,118
10513336322,Can England qualify for the knockout stages? Follow the game live with us.,2016-06-20 13:40:00,link,71,88,45,204
10606591490,The final voter turnout was estimated to be 72% nationwide.,2016-06-24 01:00:19,link,121,44,2,167
25902406772,"Oh, Marlins.........",2016-06-22 18:44:06,link,29,64,12,105
25902406772,Javier Baez is the man for this one. SO CLOSE.,2016-06-23 20:54:43,link,8,33,6,47
95926963131,She's back!,2016-06-18 10:21:01,link,139,26,5,170
10513336322,How Ikea made an exhibition of itself.,2016-06-20 09:00:00,link,115,72,9,196
7245371700,"Franchesca ""Chescaleigh"" Ramsey hosts the most *woke* underground rap battle of all time.",2016-06-22 18:31:32,video,133,45,5,183
18807449704,Fact: Getting a dog will change your life.,2016-06-16 18:00:00,link,31,48,21,100
52150999700,This HUGE Gilmore Girls question may have just been answered. 😯  (via HelloGiggles),2016-06-17 00:18:00,link,107,14,43,164
5281959998,"""Sand is the essential ingredient that makes modern life possible. And we are starting to run out."" Read on in The New York Times Opinion Section.",2016-06-23 07:55:00,link,8,48,26,82
95926963131,"We counted how many times the Kardashians say ""like"" in a single episode of Keeping Up With The Kardashians on E!—and it's a lot. (via People Video)",2016-06-18 22:00:00,video,108,96,19,223
10606591490,"""A big battle like that is no place for a direwolf.""",2016-06-21 16:30:14,link,134,39,2,175
13652355666,A pizza party happened on the House floor last night: http://usat.ly/28Qlk5K,2016-06-23 12:15:00,video,25,97,28,150
5281959998,We couldn't tell you what goes on at a black hole's center. But The New York Times - Science answered your other questions.,2016-06-19 02:25:00,link,126,30,45,201
13652355666,They haven't been seen since Father's Day.,2016-06-22 07:55:25,link,46,20,20,86
10606591490,It's about to get crazy out there.,2016-06-24 08:00:46,link,42,14,38,94
86680728811,Bernie Sanders is promising to join Hillary Clinton and the Democratic Party in a more active role in their effort to defeat Donald J. Trump.,2016-06-17 03:08:48,link,146,55,36,237
112638779551,"Atlanta Braves' Adonis Garcia did his best Vladimir Guerrero impression, and it worked.",2016-06-16 07:42:50,link,195,59,11,265
5281959998,"Campaigners for leaving the European Union want to ""take back control."" But what will they be left with? (via The New York Times Opinion Section)",2016-06-17 01:55:00,link,128,1,1,130
52150999700,This duet between Anna Kendrick and James Corden is what theater kid dreams are made of!,2016-06-23 06:40:50,link,53,64,21,138
18807449704,PUT AWAY THE FACE WASH.,2016-06-21 18:01:57,link,62,12,31,105
7245371700,Does size matter? There are some pretty valid points in Laci Green and William Haynes' discussion.,2016-06-18 14:00:00,video,38,9,24,71
18807449704,The Orlando shooter used five Facebook accounts to post various messages during the massacre.,2016-06-16 15:50:02,link,96,7,26,129
5281959998,Care for some live music and a local craft beer?,2016-06-20 14:35:00,link,98,25,19,142
75932763901,"Just two months after welcoming Baby No. 2, Kelly Clarkson has announced more exciting news! Get the details (via Closer Weekly) —> http://bit.ly/294Np8Q",2016-06-24 12:00:00,photo,181,34,43,258
86680728811,"Led Zeppelin bassist John Paul Jones testifies he was unfamiliar with the band Spirit, which is suing over the iconic ""Stairway to Heaven"" riff: http://abcn.ws/1UCjXdm",2016-06-18 09:29:30,link,33,97,19,149
86680728811,"Baltimore Ravens rookie Ronnie Stanley walked into an area animal shelter last week with a very specific request: a ""not-so-adoptable"" dog. They left ""delighted."" http://abcn.ws/1Y16jU8",2016-06-18 11:26:32,link,169,59,20,248
95926963131,Oscar Pistorius demonstrated how difficult it is to walk as an amputee. (via People True Crime),2016-06-15 18:58:04,link,96,58,46,200
10606591490,"Move over, sports drinks.",2016-06-19 05:30:06,link,35,95,17,147
5281959998,"The Islamic State's control has been shaped by about 126 places — cities, towns, infrastructure and bases — where it has had military dominance.",2016-06-20 15:30:44,link,89,54,34,177
10513336322,"""For the last 50 years the British political class has refused to engage intelligently with the issue of immigration. The Tories brazenly stoke popular prejudice while Labour cravenly submits to it.""

We may be about to face the consequences.",2016-06-16 02:40:00,link,141,3,46,190
86680728811,"Fast-moving brush fire in Santa Barbara County grows to 1,100 acres, threatening nearby structures. http://abcn.ws/25ZQzFb",2016-06-16 08:18:40,video,130,62,13,205
10513336322,"""If there's one thing the British have never done when faced with a challenge that concerns their future, their very identity, it is to make the wrong choice. A Britain less great than it is would go against the very logic of those who want an exit. It would swap autonomy for solitude, pride for weakness, and identity for self-harm.""",2016-06-22 02:00:00,link,169,87,8,264
95926963131,Chelsea Clinton and parents Hillary Clinton and President Bill Clinton are enjoying every second with their new addition. ❤️,2016-06-19 16:00:40,link,84,32,23,139
10606591490,It was something her mother taught her to embrace early on.,2016-06-21 03:00:08,link,130,51,16,197
86680728811,"Donald J. Trump painted Hillary Clinton as a ""world class liar"" in a speech today - but the irony is that many of his statements are either half-truths, unproven conspiracy theories, or outright lies. http://abcn.ws/28N6Y61",2016-06-22 16:21:08,link,25,86,20,131
95926963131,PEOPLE's Call to Action: Here's How to Contact All 535 Members of Congress,2016-06-16 13:15:00,video,98,76,26,200
75932763901,UNRECOGNIZABLE! This star has never had such a drastic makeover... See who–> http://bit.ly/28LDf0b,2016-06-21 15:30:00,photo,46,73,38,157
18807449704,Selena Gomez considers herself the O.G. of Taylor Swift's Squad.,2016-06-22 06:00:00,video,170,53,28,251
18807449704,Razors? ✅   Bloodstains? ✅  Whiskey? ✅,2016-06-17 10:26:16,link,108,63,42,213
7245371700,North has been a busy little girl. (via AOL),2016-06-17 12:21:09,link,101,86,49,236
25902406772,Henry Ellenson already knows what y'all haters are thinking about his sick trick shot video.,2016-06-22 17:00:00,video,24,34,47,105
10513336322,"""The Atlantic is the symbolic part of the flight because all the means of transportation have always tried to cross the Atlantic, the first steamboats, the first aeroplane, the first balloons, the first airships and, today, it is the first solar-powered aeroplane.""",2016-06-23 05:40:00,link,112,44,19,175
112638779551,"""It sucked to watch them celebrating. We wished that would've been us.""

Stephen Curry talks about watching the Cavaliers celebrate on their court.",2016-06-20 00:17:36,video,168,41,17,226
95926963131,"Not only did they finish together, but they won with the fastest times!",2016-06-24 03:00:15,link,157,82,27,266
112638779551,"SURVIVE AND ADVANCE! 

Clint Dempsey (goal, assist) leads U.S. Soccer to the Copa América Centenario semifinals! #Copa100 #MyCopaColors",2016-06-16 22:29:56,photo,13,33,18,64
10513336322,Michael Gove's father has contradicted claims made by his son that the family's fish processing firm in Aberdeen was destroyed by the European Union's fisheries policies.,2016-06-15 11:00:01,link,153,1,2,156
112638779551,Billy Horschel is wearing some very colorful pants at the U.S. Open,2016-06-17 10:54:51,link,78,69,25,172
7245371700,It all makes *so* much sense now.,2016-06-20 01:40:01,link,135,56,13,204
52150999700,These Finding Dory box office numbers are INSANE. 🙀,2016-06-19 12:21:00,link,66,100,23,189
10513336322,"""As viewers, we instinctively respond more to human drama than supernatural. Daenerys' dragons are instantly more engaging when she's riding one of them, or commanding them. Otherwise, we're just watching a CGI nature documentary. We sincerely hope Game of Thrones has more than just visual spectacle to rely on. It needs bastards too.""",2016-06-22 11:00:00,link,141,13,49,203
52150999700,This Hamilton: An American Musical star can do no wrong. 🙌,2016-06-15 02:52:00,link,57,10,43,110
112638779551,"The Buffalo Bills have a new assistant coach: Legendary safety Ed Reed....

And when Bills coach Rex Ryan was asked about Reed Thursday, well, he gave him the ultimate praise...",2016-06-16 17:48:23,link,17,43,33,93
25902406772,CHAMPIONS.,2016-06-19 21:38:32,photo,42,87,15,144
95926963131,Kim Kardashian West stands by her husband—even when it comes to his Taylor Swift feud.,2016-06-18 15:00:06,video,32,48,29,109
10513336322,"""The Brexit campaign looks only to tomorrow. It doesn't look to five, 10, 15, 40 years, which is what we have to do. This is my grandchildren and great-grandchildren we're talking about.""",2016-06-16 13:20:00,link,131,33,29,193
75932763901,"Courteney Cox just stepped out with her daughter, Coco — and people are freaking out over how grown up and gorgeous she is! See the pics (via Closer Weekly) —> http://bit.ly/1WMZ8xU",2016-06-15 03:30:00,photo,61,90,21,172
10513336322,"When South African police opened fire on marching schoolchildren in the township of Soweto on 16 June 1976, Makhubo's neighbours had seen her older brother, 18-year-old Mbuyisa Makhubo, drenched in blood and staggering to a clinic, carrying a limp boy in his arms. They assumed he had been gravely hurt.

In fact, it was the 12-year-old boy Mbuyisa had scooped up in the midst of the chaos who lost his life that day. His name was Hector Pieterson. A photograph of the two taken by a local journalist was printed first by a local newspaper, and then around the world.",2016-06-16 09:00:00,link,7,9,49,65
10606591490,"How would you spend the $1,500 to $2,000-worth of giveaway money?",2016-06-17 00:30:17,link,6,50,40,96
112638779551,New York Yankees prospect Jake Cave hit one of the longest home runs you'll ever see.,2016-06-16 14:56:08,link,134,88,37,259
18807449704,What could possibly go wrong?,2016-06-19 02:00:00,link,96,38,4,138
13652355666,"The Russian-born actor was best known as playing Chekov in the Star Trek reboot movie series including 2009's 'Star Trek,' 2013's 'Star Trek Into Darkness' and the upcoming 'Star Trek Beyond.'",2016-06-19 14:39:00,link,1,61,50,112
25902406772,The breakdown of the block that will go down in HISTORY.,2016-06-20 09:20:44,link,90,48,42,180
25902406772,Everyone needs a little color rush.,2016-06-18 14:11:48,link,57,5,12,74
10513336322,"""It is a question the English used to ask about their subject peoples: are they ready for self-government? But it is now one that has to be asked about the English themselves. It's not facetious: England seems to be stumbling towards a national independence it has scarcely even discussed, let alone prepared for. It is on the brink of one of history's strangest nationalist revolutions.""",2016-06-20 03:40:00,link,96,10,13,119
10606591490,"""Keep the high quality comments coming in please.""",2016-06-15 13:30:28,link,142,91,1,234
112638779551,"A couple Thursday notes coming at you, courtesy Ken Rosenthal.",2016-06-23 15:13:51,link,5,32,42,79
52150999700,These intense new Star Wars photos from #RogueOne are getting us PUMPED. 🙌,2016-06-23 12:37:39,link,174,23,25,222
25902406772,Buffalo Bills RB Karlos Williams isn't exactly in playing shape.,2016-06-15 09:51:43,link,99,41,37,177
25902406772,"Don't worry, the sign will be going back up before next season.",2016-06-21 21:45:03,link,49,17,2,68
7245371700,Kylie Jenner's new shades are giving me the ~blues~.,2016-06-23 01:11:10,link,120,80,36,236
5281959998,The greenish brown color helped discourage smokers in Australia.,2016-06-21 01:55:00,link,43,38,27,108
52150999700,Harry Potter and the Cursed Child really is that magical. ✨  🎭,2016-06-19 17:26:00,link,166,70,10,246
25902406772,A piece of Denver Broncos history could be yours.,2016-06-16 18:42:32,link,93,86,34,213
95926963131,Real Housewives of New York City star Ramona Singer says Jules Wainstein was shocked by her own divorce.,2016-06-16 00:00:08,link,106,34,35,175
95926963131,Eva Longoria Baston took to social media to wish her husband a happy one-month anniversary!,2016-06-22 00:00:23,link,51,40,14,105
10606591490,"""Junk should not be a food group.""",2016-06-18 07:00:42,link,167,84,38,289
10606591490,It's a lot more than you think.,2016-06-22 10:00:11,link,89,58,7,154
86680728811,"Former Rep. Gabby Giffords: ""Absolutely sickened to hear of the assassination of Jo Cox. She was young, courageous, and hardworking. A rising star, mother, and wife.""",2016-06-16 17:18:41,link,28,34,28,90
18807449704,Absolutely hilarious 😂,2016-06-23 05:05:48,link,38,38,24,100
5281959998,"You can now get a degree in ""comedic arts."" Seriously. There's no punchline here.",2016-06-20 12:25:00,link,186,46,4,236
5281959998,Are Hillary Clinton's conclusions about Donald J. Trump's economic policies accurate or fear-mongering? Here's how to think about it.,2016-06-21 20:25:16,link,48,32,42,122
75932763901,RIP — Read Denise Richards' sad message on Instagram —> http://bit.ly/28Qc30C,2016-06-22 16:00:00,photo,39,86,15,140
112638779551,"Roy ""Big Country"" Nelson says a fight with Brock Lesnar would break every UFC record in history.",2016-06-22 13:01:53,link,19,57,26,102
112638779551,"Ouch! Dustin Johnson hits a fan in the head with a ball

Kristen Balboni for @TheBuzzer",2016-06-18 20:09:51,video,72,68,26,166
112638779551,It's a Chile-Argentina rematch in the Copa America final,2016-06-23 01:27:26,link,136,30,41,207
86680728811,"The frequency of unprovoked alligator attacks has grown in Florida, but fatal attacks remain rare. http://abcn.ws/1U8Awdr",2016-06-15 10:51:27,link,114,5,50,169
18807449704,This alarm helps pregnant women find a seat on mass transit.,2016-06-23 10:44:05,video,18,61,27,106
7245371700,Too cute to handle.,2016-06-18 01:42:20,link,24,36,20,80
112638779551,"No NBA team has come back from a 3-1 deficit in the Finals, but we've seen 3-1 comebacks in the World Series and Stanley Cup. Why is basketball so different?",2016-06-15 15:37:18,link,193,98,10,301
52150999700,The Tanner family looks amazing together in Netflix's Full House reboot!!! 🙌,2016-06-17 13:43:00,link,187,100,33,320
10606591490,"Salman Khan: ""When I used to walk out of the ring, it was actually like a raped woman walking out.""",2016-06-21 17:01:12,link,45,17,17,79
86680728811,The car explosion could be heard for miles by residents and left a 44-year-old man badly injured.,2016-06-16 17:44:12,link,167,16,34,217
75932763901,SERIOUSLY? We can't believe this famous father lets his ten-year-old daughter run around like this (via Life & Style Weekly) —> http://bit.ly/25WmMgK,2016-06-15 00:30:00,photo,197,47,50,294
5281959998,LeBron James led the Cleveland Cavaliers to their first NBA championship with a 93-89 victory over the Golden State Warriors.,2016-06-19 21:48:34,link,39,61,49,149
7245371700,"We need answers, Disney.",2016-06-18 13:06:40,link,45,33,36,114
95926963131,Jazz Jennings' family is coming together as the teen goes in for risky surgery.,2016-06-22 19:29:03,link,120,28,48,196
86680728811,"British officials from across the political spectrum have paid tribute to their late colleague Jo Cox, who was murdered in a knife and gun attack.",2016-06-20 11:50:48,link,152,56,50,258
18807449704,YES!,2016-06-16 07:29:09,link,178,71,31,280
18807449704,Footage of hundreds of thousands of giant spider crabs will totally creep you out.,2016-06-17 02:00:00,video,78,7,39,124
18807449704,EEEEK!,2016-06-22 23:12:08,link,152,24,15,191
86680728811,"Human Rights Campaign transforms building into memorial for victims of Orlando nightclub shooting: ""We are Orlando."" http://abcn.ws/1UE1glC",2016-06-17 13:51:25,photo,27,24,33,84
112638779551,"""I might have to cut the WiFi off my at house""- Stephen Curry jokes about his wife's tweets

(via FOX Sports Ohio)",2016-06-18 17:15:50,video,178,39,9,226
18807449704,Amazing! 😍,2016-06-16 23:00:01,link,125,32,30,187
112638779551,It doesn't sound like Chicago Cubs star Kris Bryant will take part in the Home Run Derby if he's asked.,2016-06-15 15:56:36,link,151,3,16,170
7245371700,Yikes. Tonight's dates are super awkward on Are You The One?,2016-06-20 13:14:05,video,91,31,14,136
7245371700,Channing Tatum answering our deepest wishes.,2016-06-24 08:03:26,link,157,65,7,229
86680728811,An estimated 1.3 million fans gather to celebrate Cleveland Cavaliers' historic NBA Finals championship victory. http://abcn.ws/28PeMrN,2016-06-22 13:09:22,photo,185,85,8,278
10606591490,This kid got an exclusive interview with Kanye West—for 9 seconds.,2016-06-17 10:35:05,link,136,91,6,233
13652355666,"In a seven-minute video posted to YouTube, Casebolt is seen using profanity and aggressively throwing a bikini-clad 15-year-old to the ground.",2016-06-23 22:00:00,link,22,44,12,78
10606591490,Hint: It doesn't involve work.,2016-06-17 22:00:46,link,113,61,24,198
112638779551,"Twenty years ago, Stone Cold Steve Austin made a statement to the WWE Universe. The New Day - WWE pays tribute as only then can.",2016-06-23 18:26:02,link,195,24,24,243
75932763901,"If you or someone you know is contemplating suicide, please call the National Suicide Prevention Lifeline at 1-800-273-TALK (8255).",2016-06-21 13:30:00,link,61,56,9,126
75932763901,North West and Penelope Disick don't look like THIS anymore – see their over-the-top transformation! –> http://bit.ly/1XxkVII,2016-06-19 20:30:00,photo,40,43,2,85
18807449704,"Today, Greg Smith is 26 years old.",2016-06-21 18:54:50,link,138,75,45,258
75932763901,IT'S A GIRL! See who just welcomed a daughter named Ray (via Closer Weekly) —> http://bit.ly/1UT2Ken,2016-06-18 03:00:00,photo,56,59,3,118
7245371700,"""The LGBTQ community has always felt like home.""",2016-06-16 05:53:21,link,68,69,50,187
25902406772,Deyonta Davis won't let anything come between him and his dream. Davis and American Family Insurance are ready to #DreamFearlessly.,2016-06-22 18:52:46,video,56,73,22,151
7245371700,A father-daughter duo head to Bonnaroo Music and Arts Festival and discover Walt Whitman + J.Cole are more alike than not.,2016-06-19 12:26:22,link,53,12,15,80
5281959998,"""Black immigrant parents may tell their children to shrug off their encounters with racism, but what good does that do the child who must leave his house every day and be black in America?""

Read on in The New York Times Opinion Section.",2016-06-19 14:55:23,link,41,73,18,132
52150999700,"Tonight's Game of Thrones was gory, gripping and gratifying. 🔥 🔥 🔥",2016-06-19 22:00:00,link,66,63,27,156
7245371700,"This warmed my heart so much, Selena Gomez.",2016-06-23 11:46:45,link,8,63,4,75
25902406772,Ben Simmons met with the Sixers who have the Number 1 Draft Pick.,2016-06-17 13:40:07,link,39,23,35,97
25902406772,Stephen Curry's family isn't really happy with the Cleveland Cavaliers.,2016-06-16 20:57:03,link,44,43,38,125
86680728811,Photos from more than a decade ago of former President Bill Clinton and Donald J. Trump together will be released this fall by the Clinton Presidential Library.,2016-06-16 21:06:21,link,194,94,3,291
25902406772,Daniel Sturridge scores in the 92nd minute and tops it off with a legendary celebration.,2016-06-16 10:25:50,link,121,7,37,165
112638779551,"WATCH: Jordan Spieth heads to the famed Church Pew Bunkers at Oakmont. #USOpen 

#FeaturedHoles --> http://foxs.pt/24Zdfj6",2016-06-19 12:51:11,photo,132,18,48,198
10513336322,"J.K. Rowling: ""I'm not an expert on much, but I do know how to create a monster.""",2016-06-20 09:40:00,link,192,44,33,269
75932763901,"Just days after her break up, Demi Lovato throws major shade at the last person we'd expect –> http://bit.ly/1V1Hws2",2016-06-17 13:00:00,photo,162,91,25,278
5281959998,The move by YouTube puts it into more direct competition with players like Netflix and traditional cable networks.,2016-06-23 21:25:00,link,107,33,7,147
86680728811,"House Republicans are unveiling plans to repeal and replace Pres. Barack Obama's health care law. ""Today we are proposing a new approach.""",2016-06-21 23:55:09,link,36,40,12,88
7245371700,"I got chills from that, Alicia Keys.",2016-06-20 19:45:02,link,182,62,49,293
25902406772,Clevelanders have waited a loooooong time for this moment.,2016-06-20 09:40:33,photo,149,52,32,233
25902406772,Rush Propst was reportedly suspended after headbutting a player.,2016-06-16 15:58:42,link,86,72,25,183
86680728811,Two crew members stationed at a U.S. science facility at the South Pole are now on their way to receive medical attention after a daring rescue effort.,2016-06-22 17:14:00,link,165,27,49,241
52150999700,Prepare for Sunday nights to go from Game of Thrones' Westeros to the new Westworld.,2016-06-20 06:47:00,link,140,74,9,223
10606591490,"""Moi is now and has always been an ardent feminist and champion of women's rights.""",2016-06-19 03:00:32,link,184,86,44,314
95926963131,Republican Party leaders have reportedly agreed to allow a vote on two gun control measures.,2016-06-16 08:06:07,link,51,55,8,114
112638779551,"If we can't get golf at the U.S. Open Championship, cool weather photos will do.",2016-06-16 18:21:13,link,110,26,13,149
86680728811,"For the first time in decades, the summer solstice and June's full moon - the 'Strawberry moon' - will sync.",2016-06-20 14:47:48,link,180,22,18,220
10606591490,Ouch.,2016-06-15 11:30:31,link,155,98,5,258
52150999700,The future of Ghostbusters looks bright! 👻,2016-06-20 17:29:00,link,31,45,39,115
13652355666,"""Because I'm feeding my baby, this man is going crazy. ... I'm shaking.""",2016-06-16 08:46:00,link,171,87,30,288
86680728811,"WATCH: Ribbons are placed around the National September 11 Memorial & Museum's ""Survivor Tree"" in honor of the Orlando shooting victims. http://abcn.ws/1XrxB5g",2016-06-16 12:26:56,video,11,64,35,110
25902406772,The Miami Marlins could turn it on this season.,2016-06-22 13:14:05,link,23,95,17,135
112638779551,Rickie Fowler got off to a bad start at a major (again),2016-06-16 17:26:49,link,185,74,31,290
25902406772,The Carolina Panthers have all the faith in the world in Cam Newton.,2016-06-23 10:49:02,link,21,65,17,103
112638779551,The Detroit Pistons found a gem in second round of the 1986 NBA Draft.,2016-06-23 11:06:25,link,32,10,17,59
95926963131,PEOPLE Wander Words isn't your average word game!,2016-06-17 03:00:28,link,157,21,50,228
25902406772,"The Cleveland Cavaliers are champions.

And today, the city will get to witness the parade they've been waiting for.",2016-06-21 23:30:00,video,13,20,47,80
13652355666,"Symptom googlers, prepare yourselves.",2016-06-21 05:05:00,link,165,20,48,233
112638779551,"Enjoy every bit of it, Cleveland.",2016-06-20 00:51:53,link,146,36,22,204
10606591490,An estimated 10 million dogs are eaten across China each year.,2016-06-15 10:00:42,link,82,62,29,173
112638779551,There's a familiar name at the top of the U.S. Open Championship leaderboard after a long day at Oakmont Country Club.,2016-06-17 20:15:39,link,135,68,13,216
95926963131,These dogs are offering cuddles to the people who need them most—Orlando survivors. ❤️ (via PEOPLE Pets),2016-06-20 04:00:26,link,174,68,3,245
13652355666,THREE people! 🏀,2016-06-18 07:40:00,video,20,93,34,147
75932763901,"TOO FAR! Farrah Abraham's daughter is following in her footsteps — and when you see what she's doing in her latest pic, you'll understand why fans are FREAKING OUT —> http://bit.ly/28LFuS6",2016-06-21 18:30:00,photo,39,26,25,90
86680728811,"Hong Kong is the world's most expensive city for expatriates, dethroning Angolan capital Luanda from the top spot, according to a new report.",2016-06-22 15:20:25,link,95,87,4,186
5281959998,"Since 9/11, fear-mongering has been a foolproof political
tactic. After Orlando, it's unclear whether it still works. 

Read on in The New York Times Opinion Section.",2016-06-18 16:25:00,link,172,84,36,292
112638779551,This is it. This is the parade LeBron James promised Cleveland Cavaliers fans.,2016-06-22 12:36:28,video,192,96,3,291
52150999700,"Rest in peace, P.M. Dawn's Prince Be.",2016-06-17 21:59:35,link,29,10,10,49
52150999700,Liam Hemsworth tried SO hard to bring back his favorite Independence Day moment. 😂💥👊,2016-06-17 01:29:00,link,177,26,38,241
7245371700,"Who lives, who dies, who takes Winterfell on Game of Thrones?",2016-06-18 11:44:02,link,129,96,35,260
25902406772,Not good news for the Dallas Cowboys.,2016-06-15 13:07:10,link,77,13,5,95
10606591490,Have you tried Vegemite?,2016-06-16 08:00:58,link,106,16,49,171
25902406772,Brandon Marshall  isn't a fan of this diet.,2016-06-21 15:40:08,link,83,90,34,207
52150999700,That time Spider-Man met Star-Lord (aka Chris Pratt) and it was EPIC! 🙌🏻,2016-06-20 16:35:00,link,83,56,36,175
86680728811,"Donald J. Trump's former campaign manager says there is no truth to rumors his departure was, in part, the result of rifts with members of the Trump family.",2016-06-20 22:53:17,link,104,6,42,152
18807449704,Bob and Alisa draw your video game character requests for #E3 on this week's #BobDraws,2016-06-17 14:35:33,video,31,85,41,157
25902406772,Dragan Bender will be heading to the Phoenix Suns.,2016-06-23 19:32:06,link,125,85,25,235
112638779551,This is actually Pittsburgh Pirates catcher Erik Kratz's second relief appearance of the season.,2016-06-22 07:14:52,link,182,27,47,256
18807449704,"Spoiler alert, Zayn fans.",2016-06-20 16:05:09,link,90,61,41,192
112638779551,MLB commissioner Rob Manfred said there is a chance Las Vegas could have a baseball team someday.,2016-06-21 19:10:58,link,145,36,40,221
10606591490,Leonardo DiCaprio will testify in 'Wolf of Wall Street' lawsuit http://ti.me/1XZwt9Z,2016-06-17 15:00:56,video,48,88,9,145
112638779551,Roman Reigns has been suspended from the WWE for violating the wellness policy,2016-06-21 14:25:03,link,60,6,19,85
112638779551,All eight runs came on solo home runs on a strange night in Miami.,2016-06-21 07:35:56,link,48,96,30,174
10513336322,"""If the nation should fall for this deceit I can only conclude that the lives of my comrades – Irish, Scots, Welsh and English – were lost in vain. I am 96. I remember how far we have come. I know what we stand to lose.""",2016-06-16 01:20:00,link,88,23,37,148
25902406772,The Golden State Warriors face a lineup dilemma.,2016-06-15 10:57:03,link,152,11,10,173
5281959998,"The classic folk song ""This Land Is Your Land"" may literally belong to you and me.",2016-06-17 10:55:00,link,162,98,36,296
52150999700,Jon Hamm made a hilarious appearance TWICE on Parks and Recreation. 😂,2016-06-22 03:33:00,link,61,64,2,127
86680728811,National pediatrician group calling for the medical community and government leaders to make major changes to reduce the amount of lead to which children can be exposed.,2016-06-21 06:56:31,link,35,63,40,138
95926963131,"Juan Ramon Guerrero and Christopher ""Drew"" Leinonen planned to get married before they were both killed in the Orlando shooting—they will now have a joint funeral. ❤️ (via People Video)",2016-06-15 00:00:00,video,153,74,43,270
52150999700,A very special America's Got Talent contestant even gave Simon Cowell chills. ❤️,2016-06-22 09:16:00,link,78,28,24,130
75932763901,"CONGRATULATIONS! Just two months after Lindsay Lohan's engagement news surfaced, the former child star makes a MAJOR announcement —> http://bit.ly/28QlJVJ",2016-06-24 11:00:00,photo,58,1,10,69
5281959998,Sushi has become a runaway hit in NYC's Hasidic and other Orthodox Jewish precincts.,2016-06-16 21:25:00,link,12,3,9,24
18807449704,Here's what you didn't see in the Star Wars.,2016-06-21 11:53:26,link,129,91,1,221
10513336322,"""There is a childish delight to be had in going for the dunk, be it digestives in tea, bread in dripping or biscotti in vin santo.""",2016-06-23 07:00:01,link,88,50,9,147
95926963131,America's Got Talent host Nick Cannon explains how fatherhood has changed Simon Cowell. (via People Video),2016-06-19 13:00:51,video,92,78,44,214
75932763901,"BAD PARENTING?! Teen Mom star Farrah Abraham is receiving MAJOR backlash over this photo — and when you see what her six-year-old daughter is doing behind her, you'll understand why fans are outraged: http://bit.ly/28LFuS6",2016-06-21 11:00:00,photo,197,50,24,271
25902406772,Bryce Harper knows a legend when he sees one.,2016-06-22 20:47:58,link,42,68,19,129
5281959998,"""They put one cloth in my mouth and they put water, water, water,"" a former CIA prisoner said.",2016-06-16 06:25:00,link,76,95,17,188
75932763901,CONGRATS!!! Jennifer Aniston is PREGNANT! See the first pictures of her baby bump —> http://bit.ly/24PiNfY,2016-06-15 07:15:00,photo,144,87,47,278
52150999700,You aren't the only one who misses Matthew McConaughey on True Detective.,2016-06-22 23:34:00,link,38,58,29,125
18807449704,UGH. 💔,2016-06-16 01:15:00,link,84,67,23,174
112638779551,"""That is such crap!""

Jordan Spieth went off after a terrible break at Oakmont.",2016-06-16 12:35:53,link,174,24,25,223
25902406772,The Cleveland Cavaliers are on fire.,2016-06-16 23:34:35,link,60,90,12,162
52150999700,Get ready to roll in the deep–Adele is FINALLY sending her love live in the states! 🙌,2016-06-23 23:33:00,link,50,57,16,123
10513336322,"The blue section of the stadium may have been outnumbered by their red-shirted counterparts, but the noise they made to celebrate the strike was deafening.",2016-06-22 13:58:58,link,176,64,26,266
10606591490,6. Tap the camera app's hidden features.,2016-06-19 00:00:23,link,14,1,7,22
18807449704,"Thank you, James Corden and Anna Kendrick, for the love song medley we've been waiting for.",2016-06-23 10:11:43,link,128,13,6,147
10513336322,"""Not only does the UK have no effective legal bar to money laundering, but here – as in other European countries – there is no crime of mafia association. And this makes matters worse.""",2016-06-23 04:40:01,link,135,28,14,177
75932763901,"TEARS OF JOY!! After eight months of grueling cancer treatments, this celebrity kid is in remission! See who his famous dad is —> http://bit.ly/1UbJuqg",2016-06-19 09:15:00,photo,151,25,45,221
10606591490,"""On TV we just need to build a tiny part of the wall, and then we'll just CGI the rest.""",2016-06-17 14:00:23,link,99,10,34,143
7245371700,Nicki Minaj's latest verse comes just in time for the NBA Finals.,2016-06-15 21:04:14,link,6,42,49,97
7245371700,They've all come a long way. (via Entertainment Weekly),2016-06-17 23:43:07,link,100,13,41,154
95926963131,Make way for another Spy Kid: Alexa PenaVega is pregnant! (via People Babies),2016-06-16 10:19:04,link,98,74,6,178
10606591490,When will the next big earthquake be?,2016-06-23 02:30:17,link,191,46,21,258
18807449704,"Well this Instagram is a bit awkward, Naomi Campbell...",2016-06-16 17:00:00,link,124,90,6,220
75932763901,WOW! This 70-year-old star just flaunted her impressive body in a bathing suit — can you guess who? (via Closer Weekly) —> http://bit.ly/1V1x5EP,2016-06-23 00:30:00,photo,129,8,15,152
25902406772,The return of Grayson Allen makes Duke a legitimate national title contender.,2016-06-17 15:00:08,link,92,84,20,196
86680728811,"Robert Plant and Jimmy Page take the stand again in the ongoing trial over alleged copyright infringement over Led Zeppelin Official's hit song ""Stairway to Heaven.""",2016-06-21 19:50:41,link,117,86,28,231
112638779551,You'll never guess what Buddy Hield's real name is and where he got the nickname Buddy. #betcha,2016-06-23 12:39:00,video,142,48,39,229
86680728811,"NASA Astronaut Scott Kelly, who spent 340 days on the International Space Station, says being in space appears to have ""permanent effects"" on the body we ""do not fully understand.""",2016-06-16 03:31:03,link,86,82,10,178
86680728811,The name 'Hillary' rose 142% and the name 'Donald' rose 8%. But not a single baby has been named Bernie so far this year.,2016-06-22 12:12:57,link,10,44,9,63
52150999700,The new Harry Potter cast is already impressing fans. ✨  (via FanSided),2016-06-20 04:15:00,link,131,5,29,165
86680728811,College student looking for a marketing internship at GQ turns his resume into a 20-page magazine spread.,2016-06-22 03:31:07,link,11,39,21,71
18807449704,Brace yourselves.,2016-06-17 15:22:46,link,74,72,6,152
7245371700,"""Bananas as f***."" - Band of Horses on their indie rock dream team of collaborators on their latest album. 

They also talk making the same song five times and the one song that was eight years in the making.",2016-06-19 09:16:07,link,11,32,10,53
18807449704,Things escalated pretty quickly.,2016-06-18 18:00:00,link,165,52,19,236
95926963131,"Matthew McConaughey reveals the first thing that popped into his mind when he met his wife, Camila Alves.",2016-06-22 09:12:05,link,178,72,13,263
112638779551,Allen Iverson shared some words of wisdom for Ben Simmons while rocking an incredible shirt honoring two NBA greats.,2016-06-23 18:07:08,link,57,69,35,161
13652355666,It's a major victory over the Islamic State.,2016-06-17 09:46:00,link,42,38,45,125
18807449704,Say goodbye to the loser of Game of Thrones' 'The Battle of the Bastards.',2016-06-19 21:19:17,link,46,58,19,123
10606591490,It's all but impossible for Sanders to win the Democratic nomination,2016-06-19 12:30:09,link,151,89,27,267
95926963131,Real Housewives of Orange County star and her husband Jim are expecting a daughter! (via People Babies),2016-06-20 09:34:02,link,72,12,50,134
7245371700,"A little sneak peek from behind the scenes of Wonderland ✨ Watch  live performances from Run River North, Bibi Bourelly, and Kent Jones here tonight at 11pm EST!",2016-06-16 19:49:30,photo,79,12,22,113
112638779551,CJ Nitkowski has an idea to help bail out the American League in the All-Star Game.,2016-06-20 07:55:50,link,190,12,26,228
86680728811,Supreme Court won't hear a challenge on an assault weapons ban out of Connecticut. The law bans the sale of military style semi-automatic weapons and high-capacity magazines that hold 10 rounds or more.,2016-06-20 23:44:04,link,197,12,48,257
10606591490,Looking for love in the wrong places?,2016-06-18 15:00:37,link,8,65,15,88
95926963131,This 90-year-old war veteran is officially part of the 2016 graduating class! 👏,2016-06-15 07:00:43,link,159,8,36,203
86680728811,"""I explained that people think it's funny because it's endearing and people think she's funny, so she thinks it's funny.""",2016-06-21 18:41:42,link,37,70,48,155
95926963131,"Ron Shipp is saying O.J. Simpson told him he ""had dreams of killing"" ex-wife Nicole Brown Simpson.",2016-06-15 11:02:05,link,196,49,1,246
10513336322,Sad you're missing out on Glastonbury? This might help.,2016-06-22 05:00:00,link,25,9,40,74
112638779551,"No one has been picked apart and criticized more than Ben Simmons entering this NBA Draft...

And here's why everything you've heard about the future Philadelphia 76ers star is 100 percent wrong... via our Aaron Torres...",2016-06-23 09:23:24,link,90,49,20,159
13652355666,"BREAKING: Democratic lawmakers say they have had enough, and are holding the floor to demand a vote on gun control.",2016-06-22 11:23:14,link,5,84,1,90
10606591490,"His initially wary classmates started calling him ""father.""",2016-06-15 20:00:19,link,30,89,49,168
86680728811,Moment of silence held at National September 11 Memorial & Museum for victims of the Orlando shooting attack. http://abcn.ws/1XrxB5g,2016-06-16 12:19:58,video,160,20,7,187
25902406772,A championship rematch and an opening round rematch will cap off the Copa América Centenario 2016.,2016-06-22 23:36:39,link,2,35,49,86
25902406772,"June has been GOOD to Cleveland, and today was no exception.",2016-06-22 21:29:37,photo,169,63,5,237
25902406772,Karlos Dansby says some members of the Browns quit last year.,2016-06-22 13:42:31,link,176,1,34,211
52150999700,James Van Der Beek's tribute to Ron Lester is heartbreaking. 😓,2016-06-19 23:03:00,link,123,58,24,205
7245371700,"""Kanye West is a logical magnet for queer admirers because of the fire we all know and love, hate, or some mix of both.""",2016-06-23 12:20:23,link,181,28,27,236
25902406772,Former Philadelphia Eagles safety Walter Thurmond is enjoying retirement.,2016-06-15 11:42:31,link,116,72,37,225
10606591490,The toddler's body was found not far from where he was playing.,2016-06-15 23:30:06,link,39,75,43,157
5281959998,Just as delicious as you think it would be.,2016-06-20 22:55:00,link,61,58,33,152
10513336322,"""Can I suggest installing surveillance cameras in the bedrooms of the university's president and Communist party secretary?""",2016-06-16 07:20:00,link,190,48,17,255
112638779551,The running back lasted only one season in the NFL.,2016-06-17 14:47:44,link,23,79,27,129
10513336322,"Facebook has an aptly timed new hidden game within its Messenger app that challenges you to a surprisingly difficult and addictive game of keepie uppie.

And if you find that a little too straightforward, there's chess too.",2016-06-16 08:40:00,link,126,10,13,149
86680728811,"Nearly 500 firefighters are working to control a 1,200-acre brush fire north of Santa Barbara, California. ""We're at the mercy of the weather."" http://abcn.ws/1YvGfip",2016-06-16 19:22:01,video,66,32,24,122
112638779551,Is this the kind of shake-up Portland Trail Blazers fans wanted to see?,2016-06-15 20:32:55,link,15,19,50,84
112638779551,There will be some crazy contracts handed out by NBA teams this summer:,2016-06-18 14:30:16,link,185,46,13,244
10513336322,"""This is one of the things we found was really important about going offline. Kids hate being unavailable, because it's like they're dead.""",2016-06-18 07:00:01,link,79,48,11,138
5281959998,"""People will remember, a century from now, who stood up to the tyrant Donald J. Trump and who didn't,"" Timothy Egan writes in The New York Times Opinion Section",2016-06-17 22:25:00,link,190,47,30,267
25902406772,Stephen Curry makes making history look easy.,2016-06-16 22:52:35,link,123,17,5,145
5281959998,Temperature matters.,2016-06-16 21:55:00,link,76,23,5,104
7245371700,She's all about the purple hair.,2016-06-20 02:49:04,link,102,22,20,144
25902406772,"Whether it's eating pizza or dunking in Dockers, Von Miller and his dad have always shared a special connection.",2016-06-15 11:02:03,video,39,13,8,60
10606591490,"If you're looking for love, think about where you're spending your time.",2016-06-18 17:00:49,link,75,25,42,142
86680728811,"Analysts expect Shanghai Disneyland to become the world's most-visited theme park, attracting at least 15 million guests a year.",2016-06-16 05:30:16,link,50,43,44,137
52150999700,Demi Lovato is officially back on social media. 🙌🏼,2016-06-21 18:33:00,link,46,96,11,153
10513336322,"""Let's hear it for fathers. They have been asked to learn a new way of being in the world and by and large most of them have risen to the challenge with some aplomb. For one day a year at least, a celebration is surely not too much to ask.""",2016-06-19 01:00:00,link,167,5,15,187
18807449704,3. Let's not talk about what's beneath our clothes without permission.,2016-06-15 07:42:42,link,143,71,15,229
5281959998,"""ISIS sought to erase the Yazidis through killing, sexual slavery, enslavement, torture, and inhuman and degrading treatment,"" an official said.",2016-06-16 13:25:00,link,10,4,23,37
95926963131,"Jane Krakowski, Jesse Tyler Ferguson and more Broadway stars are here serenade you!",2016-06-18 17:02:42,video,28,26,4,58
7245371700,Avicii named his new album?!,2016-06-19 22:46:05,link,142,80,2,224
10513336322,"Cherry red, banana yellow, pear green … When it comes to flavour, scientists have found that visual cues like colour can be just as important to our perception of taste as ingredients. Jelly beans are identical in size and shape - perfect for a blindfold taste test. Could you guess the right flavours?",2016-06-17 07:00:00,video,83,31,4,118
10606591490,"""I had to buy him a pint after that one.""",2016-06-20 13:00:06,link,195,78,48,321
86680728811,"House Speaker Paul Ryan, who unveiled a Republican proposal on Thursday to re-assert the power of the legislative branch, said he'd be willing to sue any president—Republican or Democrat—who ""exceeds his or her powers."" http://abcn.ws/1UCmvYV",2016-06-18 09:52:00,link,32,98,44,174
75932763901,"Lookin' good, mama!",2016-06-16 00:30:00,link,130,94,48,272
112638779551,"Despite this year's #USOpen disappointment, Phil still has time to get the title he wants most.",2016-06-18 13:33:16,link,70,23,1,94
52150999700,The great Lin-Manuel Miranda is getting ready to say goodbye to Hamilton: An American Musical.,2016-06-16 10:33:00,link,28,83,21,132
112638779551,Michigan Football head coach Jim Harbaugh explains why he doesn't miss the NFL.,2016-06-23 12:48:50,link,38,6,16,60
5281959998,Think Donald J. Trump vs. Hillary Clinton vs. Bernie Sanders is unpredictable? Consider the election of 1936.,2016-06-20 19:10:00,link,12,6,7,25
5281959998,"Donald J. Trump delivered a scathing attack on Hillary Clinton's record, accusing her of being a ""world-class liar"" and incompetent.",2016-06-22 12:25:01,link,151,80,37,268
75932763901,BACHELORETTE SHOCKER: JoJo Fletcher makes the announcement no one saw coming! —> http://bit.ly/28LtM3L,2016-06-22 08:30:00,photo,167,92,12,271
112638779551,"This dude has to work pretty hard to get a haircut. 

Rachel Bonnetta for @TheBuzzer",2016-06-23 20:13:54,video,139,54,10,203
95926963131,Finding Dory broke box office records—raking in $136.2 million on opening weekend! (via People Video),2016-06-20 16:13:17,video,188,92,32,312
112638779551,"LeBron James is one of the most decorated players in NBA history, but there's one award the Cleveland Cavaliers star can't understand he hasn't won.",2016-06-19 16:57:24,link,189,74,4,267
18807449704,SO GOOD.,2016-06-18 12:41:27,link,163,41,18,222
5281959998,Thousands of debt-ridden law school graduates highlight a once unthinkable question: Should their law schools close?,2016-06-17 16:26:18,link,68,82,24,174
10606591490,Stunning.,2016-06-22 01:30:20,link,101,58,24,183
75932763901,FINALLY! It's the Miley Cyrus and Liam Hemsworth news we've ALL been waiting for —> http://bit.ly/1ZC6jXK,2016-06-15 02:15:00,photo,113,31,23,167
5281959998,"""What am I going to tell 49 grieving families?"" one senator asked. ""I am going to tell them the NRA won again.""",2016-06-21 07:25:00,link,180,43,5,228
112638779551,"Think the Golden State Warriors are nervous heading into Game 7 of the NBA Finals? Think again...

Stephen Curry and company sound VERY confident about their match-up Sunday with the Cleveland Cavaliers....",2016-06-17 12:07:16,link,80,22,38,140
7245371700,Nick Jonas does it all.,2016-06-15 05:29:06,link,56,49,1,106
95926963131,The college counselor was writing thank you notes when her alleged killer found his way into her apartment. (via People True Crime),2016-06-21 14:51:06,link,183,92,9,284
52150999700,Julia Louis-Dreyfus sure knows how to celebrate a birthday. 🙊  🎂,2016-06-18 10:34:00,link,100,18,28,146
112638779551,"""That is insane!"" This table tennis shot left the opponent smiling. 

Andy Nesbitt for @TheBuzzer",2016-06-21 17:14:36,video,86,83,7,176
75932763901,HOTTIE ALERT! This sexy young star left almost NOTHING to the imagination in her bikini —> http://bit.ly/28SDYLr,2016-06-24 16:00:00,photo,22,35,18,75
112638779551,Stephen Curry isn't backing away from the pressure as the Golden State Warriors try to finish the Cleveland Cavaliers in Game 6.,2016-06-15 21:14:22,link,130,26,24,180
112638779551,Pressure? What pressure! Jordan Spieth is ready to defend his U.S. Open Championship at Oakmont Country Club.,2016-06-15 13:00:00,video,112,89,14,215
18807449704,Here's a new way to show everyone what you're thinking.,2016-06-17 22:00:00,video,187,3,22,212
95926963131,Jennifer Aniston and Justin Theroux are all about the romantic dates.,2016-06-17 08:50:03,link,164,29,47,240
75932763901,"CHANGING FACE! Khloé Kardashian stepped out looking completely different, and fans blame plastic surgery! See the shocking transformation –> http://bit.ly/1Wg2SX5",2016-06-24 22:30:01,photo,82,93,13,188
10513336322,"George Soros: ""Today, there are speculative forces in the markets much bigger and more powerful. And they will be eager to exploit any miscalculations by the British government or British voters. A vote for Brexit would make some people very rich – but most voters considerably poorer.""",2016-06-21 06:00:00,link,79,65,14,158
18807449704,A scary moment.,2016-06-17 10:45:46,link,160,19,37,216
52150999700,Donald J. Trump has struck back.,2016-06-15 22:19:26,link,189,83,43,315
52150999700,"Listen to this incredible tribute featuring Lin-Manuel Miranda, Audra McDonald, Idina Menzel and more.",2016-06-22 06:55:00,link,108,59,3,170
52150999700,Suri Cruise is looking a lot like her mom in Katie Holmes' sweet Instagram post.,2016-06-16 21:38:27,link,132,2,4,138
25902406772,"When LeBron James gets to the launching pad, it's already too late.",2016-06-19 19:59:48,link,110,6,35,151
5281959998,"Sadiq Khan, London's new mayor, bans ""fat-shaming"" ads from the public transportation system, saying the messages encourage unhealthy body images for young women.",2016-06-15 03:25:00,link,108,55,42,205
13652355666,This is the farthest north the sun ever moves in the sky.,2016-06-20 08:15:00,link,105,78,45,228
10513336322,"Mongolia is changing all its addresses from house numbers and street names to three words phrases, making it easier to reach its nomadic population. Its based on a system called what3words which links GPS points to random yet memorable words. Every three-metre-by-three-metre square on the planet has an assigned phrase. Which one do you live at?",2016-06-17 06:00:00,video,129,85,43,257
10606591490,J.K. Rowling introduces as a new hero.,2016-06-24 02:30:12,link,42,45,15,102
95926963131,Neighbors showed support for the Graves family by decorating their home with blue and white balloons. 💙,2016-06-16 18:48:37,link,50,69,22,141
95926963131,"If you're going to battle with Anderson Cooper, you'd better know your facts!",2016-06-16 02:00:15,link,94,29,35,158
5281959998,"Out of respect for those who were killed, the Orlando shooter's corpse is being held in a different part of the morgue, said Joshua Stephany, the chief medical examiner of Orange County, Fla.",2016-06-15 20:25:01,link,76,20,12,108
7245371700,I'm so in the mood for listening to some Echo and the Bunnymen and R.E.M. right now.,2016-06-16 08:11:47,link,7,11,12,30
95926963131,One People staffer writes a love letter to her hometown—Orlando. 💙,2016-06-16 09:57:06,link,160,91,21,272
52150999700,James Gunn and Chris Pratt share EPIC Guardians of the Galaxy news in a live video.,2016-06-17 06:25:00,link,29,49,16,94
95926963131,Hollywood is shocked by the sudden and tragic death of Anton Yelchin.,2016-06-19 15:20:14,link,104,38,23,165
18807449704,Taylor Swift is NOT going to be happy with Kim Kardashian West's comments.,2016-06-16 13:34:58,link,146,12,14,172
86680728811,"BREAKING: British member of Parliament Jo Cox has died following shooting attack, police say. http://abcn.ws/1UXwZxP",2016-06-16 11:21:03,link,74,56,46,176
7245371700,Iggy Azalea wrote a pretty cordial message about the break-up.,2016-06-21 23:43:13,link,15,50,39,104
13652355666,"The raids were mounted in 16 municipalities, many around Brussels.",2016-06-19 03:50:00,link,62,74,45,181
95926963131,"According to authorities, two calls were made the night a Nebraska toddler was dragged into the Seven Seas Lagoon by an alligator.",2016-06-20 08:50:07,link,136,93,10,239
112638779551,Curb Your Enthusiasm coming back is great news for Chicago Cubs manager Joe Maddon.,2016-06-15 10:52:40,link,65,11,10,86
25902406772,The best father/son combos in baseball history.,2016-06-19 19:13:53,link,13,14,3,30
112638779551,"Tampa Bay Rays tickets for Friday's game will be $5 throughout the park, and proceeds will be donated to the Pulse Victims Fund",2016-06-15 13:23:31,link,181,7,35,223
13652355666,"Well, that ""love and respect"" thing was short-lived.",2016-06-16 03:49:00,link,51,54,41,146
112638779551,Meet Mini Thor.,2016-06-22 15:01:58,link,12,8,33,53
5281959998,"Live from London on the eve of Britain's referendum, The New York Times Opinion Section is talking about Brexit with op-ed columnist Roger Cohen.

You can read his column on Jo Cox and Britain's place in Europe here: http://nyti.ms/28MBMDY",2016-06-22 11:32:39,video,11,27,47,85
112638779551,"Johnny Miller's 63, overrated? Check out why. #Oakmont #USOpen",2016-06-15 13:44:29,link,168,69,15,252
25902406772,Well... that's pretty embarrassing.,2016-06-22 09:50:14,link,146,12,31,189
112638779551,"Day baseball at Wrigley Field is the best thing in MLB

This Chicago Cubs fan is proof.",2016-06-17 18:07:03,link,178,52,2,232
7245371700,"Laugh all you want, but this documentary seems to have a lot of terrifying twists and turns...",2016-06-18 15:08:24,link,46,55,12,113
10606591490,Justin Bieber gave four lucky kids the thrill of a lifetime.,2016-06-22 20:30:42,link,19,80,26,125
18807449704,This is so great.,2016-06-19 21:00:00,link,140,99,6,245
18807449704,Julia Louis-Dreyfus! 🙊 🙊 🙊,2016-06-17 15:00:01,link,37,17,27,81
10606591490,1. Eat right away.,2016-06-19 08:00:56,link,107,63,27,197
10513336322,"""The great gay spaces, the discos and bars, in both Buenos Aires and Barcelona were built at the same time as democracy.""",2016-06-18 11:40:00,link,98,80,45,223
25902406772,This a pretty cool moment between Christiano Ronaldo and a fan.,2016-06-18 17:01:13,link,154,45,18,217
10606591490,He fatally stabbed himself in the neck.,2016-06-17 06:00:30,link,25,61,38,124
25902406772,The King has been pretty productive.,2016-06-17 09:20:49,photo,72,95,10,177
75932763901,They were never even officially a couple — but she got PREGNANT with his baby! See who (via Closer Weekly) —> http://bit.ly/1UfJmZJ,2016-06-22 04:00:00,photo,75,21,39,135
112638779551,LeBron James is the latest NBA superstar to skip the Olympics.,2016-06-23 16:25:04,link,79,37,17,133
10606591490,"Barack Obama: ""For a baseball player, you were old, man. Let's face it. I mean, come on, man. We saw you trying to run around those bases.""",2016-06-22 15:00:24,link,100,49,14,163
10513336322,"""Look behind these faces, into the minds of the people who created the poster, and you will find those who assume we all share their unease with racial diversity. Do the great and generous British people that fought against the Nazi creed of race hate really want to give such types their day of triumph?""",2016-06-17 02:20:01,link,27,54,16,97
95926963131,The father admitted to whipping his two sons with an electrical cord during an elongated gang assault. (People True Crime),2016-06-23 12:26:05,link,33,5,6,44
86680728811,"Mongolia's 3 million citizens, some of whom are nomadic, will soon be receiving mail based on a system developed by British start-up What3Words, which assigns a unique three-word designation to every 9-square-meter area on the globe: http://abcn.ws/1ZRmukc",2016-06-15 16:06:31,link,40,15,29,84
10606591490,Adorable.,2016-06-20 02:00:10,link,143,8,36,187
112638779551,Manu Ginobili reportedly will opt out of his contract with the San Antonio Spurs,2016-06-22 10:28:38,link,127,93,21,241
95926963131,Bobby Brown is making even more shocking claims about his relationship with Whitney Houston in his new memoir.,2016-06-15 16:45:06,link,92,98,4,194
13652355666,"Sagun's favorites for those who plan to get their start today? Triangle pose, reclining hero pose and pigeon pose.",2016-06-21 18:40:00,link,24,37,20,81
86680728811,"WATCH: Turkish police fire tear gas, rubber bullets to disperse demonstrators who gathered for a gay pride rally in Istanbul despite a government ban. http://abcn.ws/1UEDVEp",2016-06-19 19:36:59,video,59,19,34,112
52150999700,Baby Daddy's Derek Theler reveals he once kissed Lauren Conrad on The Hills! http://share.ew.com/B1ZFvVR 😘,2016-06-15 23:49:00,video,94,10,41,145
112638779551,"The Cleveland Cavaliers turned their city into the world's biggest party on Wednesday. Congrats, Cavs fans. (By the way, has anyone seen J.R. Smith's shirt?)",2016-06-22 17:36:49,link,93,16,32,141
86680728811,"A neighbor said she had long felt that ""something isn't right"" at a Bucks County home where a man is accused of sexually assaulting a teenager whose parents police say gave her to him when she was 14. http://abcn.ws/1ScIy2I",2016-06-19 18:48:28,link,175,81,3,259
10606591490,There are some improvements—but they're not exactly brag-worthy.,2016-06-22 09:30:25,link,170,50,27,247
5281959998,"After the clashes between Russian and English fans ahead of a Euro 2016 game in Marseille, France, the Russian national soccer team received a suspended disqualification. Some fans face deportation.",2016-06-16 01:55:00,video,34,25,40,99
7245371700,I don't know how I feel about these new couples...,2016-06-23 11:16:11,link,69,90,38,197
18807449704,*running out the door*,2016-06-18 22:00:00,link,36,62,15,113
5281959998,"Jimmy Page and Robert Plant of Led Zeppelin Official said they were grateful the jury confirmed ""what we have known for 45 years.""",2016-06-23 14:29:27,link,56,39,25,120
18807449704,"The Battle of the Bastards is over but it was NOT very safe, Game of Thrones fans.",2016-06-20 17:11:09,link,42,10,10,62
10606591490,2. Sticky eyes.,2016-06-23 06:30:21,link,16,37,48,101
95926963131,"During the investigation, trappers humanely removed six alligators from the area.",2016-06-22 18:45:12,link,4,22,20,46
95926963131,Kourtney Kardashian and Kim Kardashian West are already teaching their young ones the meaning of giving.,2016-06-23 20:52:07,link,128,82,26,236
112638779551,Stephen Curry won't watch film of Game 7 but already knows what he'll take away from losing to the Cleveland Cavaliers.,2016-06-21 12:20:11,link,9,49,22,80
86680728811,Marine combat dog that served two tours in Afghanistan and went on 240 missions is laid to rest. RIP Rico.,2016-06-20 13:53:33,link,195,32,41,268
52150999700,The Walking Dead cast is helping Orlando victims in any way they can. ❤️,2016-06-20 09:15:18,link,171,80,14,265
95926963131,Angelina Jolie Pitt is telling all in her latest interview.,2016-06-17 10:40:06,link,49,95,10,154
112638779551,Derrick Rose is no longer a member of the Chicago Bulls. What does that mean for everyone involved?,2016-06-22 15:51:42,link,122,80,30,232
10606591490,Skipping the weight room.,2016-06-17 21:01:11,link,34,53,36,123
112638779551,"Tiger Woods gave a health update on Wednesday, saying he hasn't ruled out any upcoming tournaments.",2016-06-22 11:30:49,link,48,30,3,81
52150999700,A tense trailer for the Tupac biopic has arrived on what would've been the rapper's 45th birthday.,2016-06-16 09:01:17,link,173,66,25,264
95926963131,There's an exciting new Duggar announcement!,2016-06-20 11:24:03,link,119,75,43,237
13652355666,The U.K. is about to become the first nation to leave the EU.,2016-06-23 23:04:31,link,6,61,2,69
18807449704,Turns out pregnancy is mildly horrifying when you consider what's really going on inside the pregnant body.,2016-06-23 03:00:00,link,106,70,29,205
7245371700,Lil Wayne is skating off into recovery.,2016-06-16 21:59:14,link,25,55,17,97
112638779551,"Will injuries be a factor in Game 7? 

They have already taken a toll on the Golden State Warriors loss of Andrew Bogut.  As the final night of NBA closes in, our very own Dr. Robert Klapper breaks down what's going on with Kyrie Irving's foot and Andre Iguodala's back.",2016-06-19 10:55:55,video,1,45,36,82
10513336322,"""Recently a new kind of religion has arisen; one engineered for a godless age and specifically designed to make its devotees feel worse about themselves more often than they feel better. Like all religions it is based on hocus-pocus, misdirection and delusion. This new religion is called The Diet.""",2016-06-16 08:20:01,link,5,28,25,58
112638779551,The veteran center is turning down $23.2 million so he can become a free agent.,2016-06-21 17:36:03,link,183,50,34,267
112638779551,That's some arm the Minnesota Twins youngster is sporting.,2016-06-15 07:28:07,link,142,93,9,244
10606591490,"""Credit or debit?""",2016-06-16 04:00:17,link,22,98,4,124
10513336322,"""From the moment of his election as president of the IAAF , Sebastian Coe has seemed like a man trying to rescue his reputation in the face of intense and often hostile scrutiny. The descent from national treasure, in the wake of London's golden Olympic summer, to poster boy for the glib complacency of global sport's elite, had been dizzyingly swift.""",2016-06-16 06:00:01,link,143,30,42,215
10606591490,The Senate could not pass four different proposals to curb gun violence,2016-06-20 19:30:03,link,163,36,1,200
7245371700,He was literally the coolest dad on TV.,2016-06-17 20:50:32,link,129,33,19,181
86680728811,"Timelapse video shows intense flash flooding pour into a metro station in Cleveland Park, Washington D.C.",2016-06-22 15:51:28,video,148,82,1,231
7245371700,"Aww, it's hard to spread your wings in this big, big world.",2016-06-17 00:46:04,link,197,5,37,239
5281959998,Get ready for Game 7.,2016-06-16 22:56:42,link,67,82,42,191
86680728811,"JUST IN: Department of Homeland Security issues new National Terrorism Advisory System bulletin in aftermath of Orlando attack, urging increased ""public vigilance and awareness."" http://abcn.ws/1U9OLOY",2016-06-15 13:09:29,photo,81,14,23,118
13652355666,Two words: Airplane mode.,2016-06-19 16:15:00,link,74,25,18,117
112638779551,Carlos Condit names a couple of fights that would bring him out of his self-imposed hiatus to compete in the UFC again.,2016-06-16 20:25:38,link,158,20,39,217
95926963131,Shopping for sunglasses has never been easier!,2016-06-16 21:24:35,photo,97,98,12,207
7245371700,blink-182 has me channeling my inner teen.,2016-06-21 20:34:05,link,144,6,48,198
52150999700,Elton John and people around the world are really feeling all the love. ❤️💛💚💙💜,2016-06-15 09:47:14,link,8,49,39,96
86680728811,"Boeing says it signed agreement with Iran Air ""expressing the airline's intent"" to buy its aircraft.",2016-06-21 10:15:19,link,41,50,21,112
52150999700,Netflix's Orange Is the New Black is full of well-curated musical moments. (via MTV),2016-06-18 02:22:00,link,15,87,47,149
112638779551,Mark Cuban steps up big time for Dallas LGBT community after Orlando tragedy.,2016-06-16 09:12:04,link,102,55,31,188
25902406772,Sounds like Al Horford is still in the Atlanta Hawks' plans.,2016-06-22 18:36:59,link,84,51,28,163
13652355666,"""People have to be their own first responders.""",2016-06-21 03:00:00,link,50,5,13,68
86680728811,"An estimated 50,000 people attended a candlelight vigil Sunday night to remember the 49 people killed in Orlando last week, event organizers said.",2016-06-20 06:33:28,link,113,30,44,187
86680728811,Remembering the 49 lives lost in the Orlando nightclub shooting. http://abcn.ws/1W1ULhv,2016-06-16 16:37:53,link,45,16,11,72
112638779551,The U.S. Open Championship was paid a visit by the Pittsburgh Penguins and the Stanley Cup.,2016-06-16 14:24:35,link,79,48,25,152
10606591490,Dad's often don't take much time off.,2016-06-17 05:00:04,link,104,38,18,160
10606591490,Take a cue from these countries' morning meals.,2016-06-15 00:30:22,link,164,45,15,224
5281959998,"""I've never seen a juror tell a judge, I can't be fair because of the judge,"" a deputy district attorney said. ""It was shocking.""",2016-06-15 20:56:24,link,105,25,31,161
112638779551,What on earth is happening with Dustin Johnson at the #USOpen? Fellow players weigh in as a penalty looms while DJ tries to fend off competitors to earn his first major.,2016-06-19 18:29:43,link,12,57,13,82
25902406772,This is a pretty cool moment here between the two.,2016-06-17 11:13:23,link,76,19,47,142
18807449704,Germany's coach apologized after he was seen scratching his private parts then sniffing his fingers on live television.,2016-06-15 20:50:46,link,166,73,12,251
112638779551,"""Upon reflection, we regret the distraction caused by our decision to wait until the end of the round to decide on the ruling.""",2016-06-20 17:04:36,link,160,6,9,175
86680728811,"Orlando Police Department Chief John Mina: ""They just wanted to get those people out of there."" http://abcn.ws/1Qc0bp7",2016-06-17 14:12:28,link,168,5,43,216
52150999700,Star Wars' Han Solo isn't the only awesome Han around. 🙏,2016-06-19 19:31:00,link,79,52,20,151
86680728811,"When Stacey Feeley realized her 3-year-old daughter was practicing an active shooter drill, she said it broke her heart. ""Politicians - take a look. This is your child.""",2016-06-22 05:30:32,link,24,42,2,68
75932763901,"Kylie Jenner goes nude on Instagram — and when you see the bottom half of this pic, you'll understand why everyone's freaking out! —> http://bit.ly/1rsJp9y",2016-06-16 16:00:00,photo,79,60,5,144
25902406772,Craig Sager is a legend.,2016-06-16 22:56:03,link,110,7,38,155
112638779551,"Already ready for more golf? Us too. Shane Bacon welcomes Curtis Strange to the Clubhouse Podcast tomorrow.

SUBSCRIBE:",2016-06-19 19:59:20,link,9,87,24,120
10606591490,Ben Affleck doesn't hold back.,2016-06-23 12:30:23,link,6,48,9,63
7245371700,"Beyoncé has fooled us all, again.",2016-06-17 01:13:11,link,62,17,33,112
86680728811,Dramatic surveillance video released this week shows heroic student take down Seattle Pacific University gunman in 2014. http://abcn.ws/1Xqu2fG,2016-06-15 23:37:27,video,22,53,7,82
7245371700,Can I be their style triplet?,2016-06-23 04:05:58,link,21,88,1,110
95926963131,"How Michael Jackson's kids Paris, Prince and Blanket are coping 7 years after their father's death. (via People Video)",2016-06-22 19:07:00,video,174,63,33,270
10513336322,"""Officers attended and, during engagement with the man, it is understood a Taser was discharged. The man became unresponsive and was subsequently pronounced dead. The IPCC has begun an independent investigation.""",2016-06-15 03:50:15,link,50,100,37,187
95926963131,The Girl and the Dreamcatcher's Dove Cameron and fiancé Ryan McCartan's  latest project is an especially personal one.,2016-06-16 16:11:07,link,175,84,23,282
10513336322,"""I find no violation of human dignity, right to privacy and right to freedom of the petitioners.""",2016-06-16 10:40:00,link,121,34,28,183
112638779551,"Rickie Fowler says there's ""a bit of a gap"" between him and the three best players in the world.",2016-06-15 15:32:27,link,141,100,31,272
18807449704,Where does your favorite Game of Thrones villain rank?,2016-06-22 13:00:01,link,198,65,44,307
95926963131,Oscar Pistorius says he's willing to accept time behind bars for what he claims was the accidental shooting of his girlfriend.,2016-06-23 13:32:05,link,117,14,13,144
95926963131,"He's won over  two former Bachelorettes, and now this returning bachelor will be shaking things up in Paradise.",2016-06-21 07:44:02,link,200,54,40,294
10606591490,Awe-inspiring.,2016-06-19 18:30:09,link,9,24,46,79
52150999700,Newt Gingrich really made for an unforgettable moment on Parks and Recreation. 😂,2016-06-18 01:31:00,link,74,19,20,113
25902406772,"It's NBA Draft time. Join our experts for instant analysis of every pick.

Comment with your questions to have them answered by our #squad.",2016-06-23 18:30:30,video,180,96,40,316
13652355666,Channing and Lane were playing in the same spot — less than hour apart.,2016-06-20 10:20:00,link,23,34,35,92
86680728811,"California father spends $900 to buy full-page ad in Idaho newspaper seeking a wife for his son. ""Please bring a short one page description, background and a current photo.""",2016-06-22 14:52:40,link,34,46,35,115
86680728811,"After nearly 15 hours, Senator Chris Murphy yields the floor after leaders of both parties reach apparent agreement on gun control legislation vote. http://abcn.ws/28GrX3h",2016-06-16 01:28:30,video,82,44,50,176
75932763901,"Priscilla Presley was once known for her incredible beauty — but since these photos were taken, she's undergone so much plastic surgery that she's become UNRECOGNIZABLE! —> http://bit.ly/263FIqp",2016-06-18 21:45:00,photo,132,81,23,236
10513336322,"#BREAKING: An alligator has dragged a two-year-old boy into a lagoon near the Walt Disney World resort in Orlando. Police say the boy's father tried to pull his son from the alligator's mouth, but was unable to save the child.",2016-06-15 00:13:23,link,101,99,25,225
112638779551,"""I'm going to hug you on TV now.""",2016-06-19 02:07:37,link,167,63,37,267
112638779551,The Boston Celtics have selected a small forward out of Cal with their third overall pick.,2016-06-23 19:03:05,link,107,65,46,218
25902406772,Teams have some big decisions to make in the 2016 NBA Draft.,2016-06-22 09:11:04,link,28,13,49,90
25902406772,Pretty clever there Cleveland.,2016-06-20 21:54:55,link,17,72,35,124
25902406772,There is no love lost between the Dallas Cowboys and Philadelphia Eagles.,2016-06-15 17:54:47,link,97,54,32,183
95926963131,Blake Lively spent Father's Day watching her husband get intimate with another woman—and she's handling it surprisingly well.,2016-06-21 11:31:05,link,101,45,6,152
13652355666,Good help is hard to find.,2016-06-20 18:44:00,link,77,70,38,185
13652355666,We could see a re-run of Scotland's 2014 independence referendum.,2016-06-24 03:00:00,link,103,87,42,232
25902406772,Daaaaaang. The Broncos swooped right in with the savagery.,2016-06-20 12:55:03,link,174,46,38,258
25902406772,DeMarcus Ware can... sing?,2016-06-16 11:21:43,link,42,27,48,117
25902406772,This is not good at all.,2016-06-17 17:17:32,link,36,78,48,162
5281959998,"Today is the first day of summer. Here, a child in South Williamsburg, Brooklyn, ducked from the afternoon sun.

Photo: George Etheredge/The New York Times",2016-06-20 18:25:00,link,23,13,30,66
25902406772,Ben Simmons leads the way.,2016-06-19 13:58:36,link,93,79,8,180
25902406772,The Dallas Cowboys congratulate their guy LeBron James.,2016-06-20 12:48:53,link,122,84,4,210
112638779551,Damien Sandow is embracing his recent release from WWE,2016-06-15 11:12:45,link,61,77,5,143
10606591490,"He wants to develop a ""household robot.""",2016-06-21 04:30:03,link,54,41,35,130
10606591490,Incredible.,2016-06-17 18:30:31,link,169,69,13,251
86680728811,"Bernie Sanders inches closer to admitting defeat in the race for the Democratic Party's presidential nomination. ""It doesn't appear that I am going to be the nominee.""",2016-06-22 15:30:54,link,64,51,19,134
25902406772,"The idea of relegation in college football isn't new, but this plan takes things to an entirely new level.",2016-06-16 10:55:07,link,156,43,38,237
112638779551,The New York Mets haven't had their captain in the lineup since May 27 -- and the situation could get worse.,2016-06-15 08:46:54,link,160,54,34,248
25902406772,Cam Newton thinks he can keep getting better.,2016-06-20 17:32:02,link,199,61,24,284
112638779551,Should LeBron James win Finals MVP if the Cleveland Cavaliers lose Game 7?,2016-06-18 19:38:40,link,149,98,26,273
112638779551,Who does Vegas have as the favorite to win the U.S. Open Championship trophy at Oakmont Country Club this weekend?,2016-06-15 12:15:17,link,151,50,8,209
95926963131,Walt Disney World Resort officials are taking action after the tragic death of 2-year-old Lane Graves.,2016-06-17 18:22:04,link,26,15,14,55
7245371700,Not only that. There's a great card here that Taylor Swift should give to Selena Gomez.,2016-06-18 22:56:46,link,186,73,46,305
95926963131,"From cheeseburgers to bad TV, stars love themselves some good old US of A.",2016-06-23 03:00:00,video,24,100,16,140
112638779551,"Game 7 it is! Cleveland Cavaliers take down the Golden State Warriors, 115-101.

LeBron James goes OFF again: 41 Pts, 11 Ast, 8 Reb, 4 Stl, 3 Blk #NBAFinals",2016-06-16 22:53:22,video,38,56,18,112
25902406772,LeBron James isn't going anywhere.,2016-06-22 12:24:17,photo,160,57,42,259
13652355666,Danielle is forecast to hit the east coast of Mexico later today.,2016-06-20 12:27:00,link,78,55,27,160
75932763901,"""Maybe in a couple years, we'll get back together and have some more babies."" See which star is hoping for a reconciliation with her ex —> http://bit.ly/1Sbobms",2016-06-19 07:45:00,photo,188,25,24,237
13652355666,Check this off your bucket list.,2016-06-18 19:34:00,link,176,55,44,275
10513336322,"""A relaxed 'summer's here' mood will enter the kitchen.""",2016-06-19 10:40:00,link,38,27,19,84
10606591490,Where will you go?,2016-06-19 23:30:07,link,23,43,17,83
10513336322,"""It was as though the needle was uncovering these images on my arm, rather than adding them.""",2016-06-21 06:20:00,link,20,22,34,76
7245371700,"""The violence in Orlando was a continuation of politics as usual. It is the grotesque consequence of the status quo.""",2016-06-19 09:49:35,link,166,55,30,251
10606591490,"""2016 will be a year they never forget.""",2016-06-16 03:00:37,link,26,27,50,103
25902406772,This New York Jets and Ryan Fitzpatrick thing just keeps dragging along.,2016-06-16 17:25:01,link,160,76,16,252
7245371700,I think we all needed this.,2016-06-19 18:27:05,link,125,15,9,149
7245371700,"This week's roundup of music hits & misses includes a ""Panda"" freestyle gone wrong + tracks from Danny Brown, twenty one pilots, & Kaiser Chiefs.",2016-06-17 19:49:36,link,154,14,16,184
10606591490,Oops.,2016-06-22 13:00:44,link,21,66,44,131
112638779551,The rain proved too much at the U.S. Open Championship at Oakmont after several delays.,2016-06-16 16:07:58,link,34,53,24,111
10606591490,She had been robbed— of cheese.,2016-06-22 04:00:11,link,50,82,32,164
25902406772,The New York Mets are changing Thor's start.,2016-06-21 14:07:57,link,38,9,32,79
5281959998,The transcripts will include 3 calls between Omar Mateen and negotiators who spoke with him as the massacre was unfolding.,2016-06-19 12:40:00,link,166,93,38,297
75932763901,This little munchkin is having the BEST time with her famous mommy! — Click to see their super cute vacation pic —> http://bit.ly/21mYFRL,2016-06-21 22:01:00,photo,144,85,16,245
52150999700,The all-female Ocean's Eleven (2001) reboot sounds AWESOME! 👌🏼,2016-06-15 11:12:00,link,122,86,28,236
10606591490,It's good for your brain.,2016-06-17 03:30:11,link,75,98,10,183
112638779551,"Craig Sager has never worked an NBA Finals.

That changes on Thursday.",2016-06-15 10:00:57,link,131,90,9,230
112638779551,"""F-bombs directed toward a little girl...telling her that she should tell her parents to kill themselves...It's absurd.""",2016-06-19 16:12:06,link,69,93,22,184
112638779551,Where it all begins. Take a closer look at the diabolical first hole at the U.S. Open Championship. #USOpen,2016-06-19 11:13:46,video,181,51,33,265
52150999700,Kim Kardashian West is finally addressing the portrayal of her family on the show.,2016-06-16 12:15:00,link,36,80,20,136
25902406772,But first let me...,2016-06-15 23:08:18,link,113,9,36,158
112638779551,The Indiana Pacers keep on dealing ahead of the NBA Draft.,2016-06-23 14:03:19,link,89,69,7,165
112638779551,"Urban Meyer had a record 12 Ohio State Buckeyes selected in the first four rounds of the 2016 NFL Draft, and DIDN'T win this one.",2016-06-15 19:55:48,link,199,30,14,243
75932763901,YIKES! This young Hollywood star just confessed to getting a boner on the red carpet! —> http://bit.ly/28FpSod,2016-06-15 17:30:00,photo,22,92,19,133
95926963131,T.I.'s stepdaughter was arrested on Thursday.,2016-06-17 22:05:57,link,13,63,42,118
86680728811,"2-year-old boy was with his family visiting from Nebraska when the alligator attacked, authorities said. ""The father entered the water and tried to grab the child from the gator, but was not successful.""",2016-06-15 01:49:16,link,49,88,47,184
7245371700,Coincidence?,2016-06-19 13:45:03,link,178,47,36,261
5281959998,"On June 12, 49 people were shot dead at Pulse, a gay nightclub in Orlando. This is who they were.

For fuller portraits of all the victims, read here: http://nyti.ms/1WNShEq",2016-06-15 14:55:00,video,66,81,45,192
75932763901,REVENGE: Calvin Harris throws major shade after Taylor Swift is spotted with another man just days after their split! —> http://bit.ly/1ZTYjBu,2016-06-16 10:38:37,photo,157,96,47,300
75932763901,IT'S A BOY! See which star is expecting another son (via Closer Weekly) —> http://bit.ly/1OkyPqu,2016-06-21 06:45:00,photo,43,55,7,105
10606591490,Ouch.,2016-06-16 11:00:22,link,141,95,35,271
75932763901,"Looking good, Kylie Jenner.",2016-06-22 20:00:00,link,37,42,31,110
5281959998,The Cassini spacecraft is dancing toward death — and Saturn — and NASA wants to make sure it doesn't take any alien life with it.,2016-06-22 11:55:00,link,136,76,14,226
10513336322,"""Inside the park, which is the size of nearly 600 football pitches , day trippers will find the largest Disney castle on earth, a pirate-themed stunt show, a Mandarin version of the Lion King Broadway musical and a hair-raising, neon-lit rollercoaster called the TRON Lightcycle Power Run.""",2016-06-17 07:20:01,link,77,87,22,186
10606591490,"From his tumultuous childhood, to performances at sold-out stadiums.",2016-06-16 13:00:25,link,159,42,11,212
25902406772,"Now Presenting: Billy Hamilton's ""The Flash"" impression.",2016-06-18 16:46:15,link,58,87,49,194
95926963131,Costars and other celebrities are remembering Star Trek actor Anton Yelchin after his sudden and tragic death over the weekend. (via People Video),2016-06-21 07:22:00,video,33,62,34,129
25902406772,Dustin Johnson is FINALLY over the hump.,2016-06-20 00:11:37,link,146,2,39,187
25902406772,ALLLLLLLL the stars are out for Game 7.,2016-06-19 20:42:39,link,190,2,35,227
13652355666,"""I'm not going to just move him past Tim Duncan and Kobe. They didn't just die.""",2016-06-23 09:58:00,link,67,76,23,166
5281959998,"During UEFA EURO 2016, there's a song for every fan. If you're English, this might be a favorite:

We're England 'til we die
until we die, until we die
We're England 'til we die
until we die, until we die",2016-06-20 00:25:00,link,50,69,35,154
112638779551,"Richard Jefferson tells Klay Thompson to 'shut up' about his complaints

http://www.foxsports.com/nba/story/richard-jefferson-tells-klay-thompson-to-shut-up-about-complaints-061516",2016-06-15 15:07:36,link,107,11,37,155
25902406772,A shockingly early exit for Rory McIlroy.,2016-06-18 14:49:48,link,171,32,19,222
95926963131,Jinger Duggar is courting—and she will be expected to abide by these strict rules set forth by her parents.,2016-06-21 07:00:58,link,148,47,48,243
52150999700,A LOT more people are going to be Finding Dory this weekend. 🐠💸,2016-06-16 16:42:00,link,59,20,17,96
75932763901,See the hottest looks from the iHeartRadio Much Music Awards! —> http://bit.ly/28JDMAq,2016-06-20 14:30:00,photo,45,91,28,164
5281959998,Hillary Clinton skewered Donald J. Trump's economic proposals in a speech on Tuesday.,2016-06-21 12:26:55,link,129,3,33,165
75932763901,Calvin Harris claims he didn't cheat on Taylor Swift before the breakup — but THIS naked pic that just leaked tells a different story! –> http://bit.ly/1XZE6wS,2016-06-17 15:00:00,photo,34,69,35,138
95926963131,What you need to know to safely get out of an alligator encounter. (via PEOPLE Pets),2016-06-15 13:56:06,link,197,6,42,245
10606591490,90% of millennials say they use coupons.,2016-06-17 03:00:46,link,81,92,23,196
86680728811,"While this Colorado courthouse allows service animals into the building, security guards drew the line when someone tried to sneak his pet iguana through the X-ray machine.",2016-06-18 07:57:21,link,45,16,48,109
75932763901,The Bachelor alum Ben Higgins just made a shocking confession about JoJo Fletcher that can end his engagement! —> http://bit.ly/262oM3A,2016-06-15 10:05:00,photo,37,14,30,81
112638779551,WATCH: Race driver clears the fence in an incredible sprint car crash.,2016-06-17 13:56:36,link,56,59,7,122
86680728811,"British Prime Minister David Cameron pays tribute to slain lawmaker Jo Cox: ""Service, community, tolerance - the values she lived by and worked by, those are the values that we need to redouble in our national life."" http://abcn.ws/1YxmQNT",2016-06-17 10:49:29,video,147,79,33,259
95926963131,Blake Lively is the fourth actress to confirm there may be another Sisterhood movie. (via HelloGiggles),2016-06-22 22:00:52,link,195,24,24,243
13652355666,Omar Mateen legally purchased the weapons from a Florida store on consecutive days about a week before the rampage.,2016-06-15 01:50:00,link,47,70,17,134
7245371700,They go a little more in-depth into Marissa's tragic storyline and fighting to keep one iconic controversial scene in season 1.,2016-06-17 18:51:08,link,132,27,20,179
13652355666,A baby and his Boxer BFF love to cuddle and play together!,2016-06-17 19:49:00,video,18,81,20,119
10513336322,Who's making waves at Euro 2016?,2016-06-15 05:30:48,link,39,27,8,74
112638779551,"It's a little over a week until the NBA Draft, who are the Philadelphia 76ers, LA Lakers and Boston Celtics going to take? 

We have the answer, in our latest, updated NBA Mock Draft, via Aaron Torres...",2016-06-15 08:02:21,link,147,29,6,182
75932763901,WARNING: These details may difficult for some.,2016-06-16 21:30:00,link,47,61,34,142
75932763901,Do you remember when Ellen DeGeneres first made Sophia Grace famous?! Well today she's a TEENAGER – and looks totally grown up! –> http://bit.ly/27zF9q3,2016-06-22 21:30:01,photo,154,26,48,228
25902406772,"SO MUCH happening Sunday night, so we'll help you keep an eye on WWE action.",2016-06-19 16:43:21,link,60,17,45,122
7245371700,As if I wasn't already afraid of roller coasters.,2016-06-18 19:07:03,link,84,21,20,125
86680728811,"Bill and Hillary Clinton say they're ""over the moon"" about the birth of their second grandchild, Aidan. http://abcn.ws/21sH6Q7",2016-06-18 19:01:07,link,125,6,3,134
18807449704,"We've got answers, Harry Potter fans.",2016-06-20 19:19:29,link,33,29,15,77
25902406772,"Passion and focus allowed Henry Ellenson to #DreamFearlessly. Tonight, his basketball dreams become a reality at the NBA Draft with American Family Insurance.",2016-06-23 17:30:00,video,129,4,40,173
10606591490,Reviewing Game of Thrones' 9th episode of season 6,2016-06-20 08:50:33,video,71,38,43,152
18807449704,"YES, PLEASE.",2016-06-18 15:56:24,link,48,93,28,169
75932763901,Britney Spears and sister Jamie Lynn Spears are hardly EVER photographed together – that's why these pics have fans everywhere FREAKING OUT! –> http://bit.ly/1PQFLuO,2016-06-19 18:30:00,photo,80,94,12,186
13652355666,This is what makes Grand Teton National Park so grand. http://usat.ly/260CqEo,2016-06-16 13:44:00,video,70,30,25,125
5281959998,The TSA hoped PreCheck would solve the problem of those long lines at airport security. It has not worked as planned.,2016-06-22 14:55:00,link,73,10,21,104
7245371700,What a week for Nick Jonas.,2016-06-17 00:18:01,link,114,92,36,242
52150999700,Darth Vader is BACK for '#RogueOne: A Star Wars Story'—and he's more angry and merciless than ever. 😱,2016-06-23 08:26:09,link,37,26,45,108
13652355666,"""We're proud to celebrate all dogs and pets by showing that no matter their imperfections, they are adoptable, lovable and a great add to any family.""",2016-06-23 19:00:00,video,92,43,9,144
86680728811,"Utah Lt. Gov Spencer Cox apologizes to LGBT community: ""I will forever regret not treating them with the kindness, dignity and respect — the love — that they deserved. For that, I sincerely and humbly apologize."" http://abcn.ws/1Ubl9Rq",2016-06-16 13:11:51,link,94,92,5,191
25902406772,Bad news for Golden State Warriors fans.,2016-06-15 11:03:32,link,76,64,50,190
25902406772,Louisville's president won't be there much longer.,2016-06-17 10:45:41,link,185,58,18,261
112638779551,'Serena' features the world No. 1 doing karaoke to Gloria Estefan's 'Conga' in the presence of Drake. #SerenaWilliams #Wimbledon,2016-06-23 16:34:14,link,44,19,19,82
10513336322,Why is Britain on the brink of leaving the European Union?,2016-06-22 18:00:01,link,126,100,8,234
95926963131,"People's List people, you can talk to cohosts Jerry O'Connell and SuChin Pak plus ESPN contributor Will Reeve. Have questions? Comments? Dares? They are so game and want to talk to YOU.",2016-06-16 19:26:09,video,146,11,26,183
95926963131,Facebook CEO Mark Zuckerberg is about to get a lot of likes! (via People Babies),2016-06-19 16:20:11,link,77,81,32,190
13652355666,History can be so fickle.,2016-06-18 02:50:00,link,1,39,16,56
5281959998,Inside the Republican Party's identity crisis.,2016-06-21 06:55:00,link,33,16,41,90
25902406772,MAJOR MOVES going down at the draft.,2016-06-23 20:14:21,photo,99,64,46,209
75932763901,SERIOUSLY?! We weren't expecting Taylor Swift to reveal THIS so early in her new relationship —> http://bit.ly/28OgOop,2016-06-23 02:15:00,photo,22,4,42,68
25902406772,What. A. Pup.,2016-06-19 17:02:37,link,138,72,37,247
86680728811,"Donald J. Trump calls the campaign funds Hillary Clinton has raised ""blood money.""",2016-06-22 09:36:48,link,190,94,29,313
25902406772,LeBron James shows you how to close out in Game 7.,2016-06-20 09:41:40,link,89,99,35,223
112638779551,"Villanova Basketball star Kris Jenkins crushed the soul of every North Carolina Tar Heels fan when he hit that epic game-winner in the NCAA title game. 

Yet despite it, North Carolina's players were still nice enough to invite Jenkins to play pick-up this off-season...",2016-06-15 16:42:02,link,112,34,42,188
86680728811,Some of Broadway's biggest stars teamed up to record a touching song honoring victims of the Orlando nightclub shooting.,2016-06-21 06:28:06,link,166,13,15,194
25902406772,"Not actually a LeBron James interview, but you get the point... HE'S READY.",2016-06-16 22:57:21,video,82,27,4,113
75932763901,So sweet! See which famous mom posted this intimate breastfeeding pic with her son (via Closer Weekly) —> http://bit.ly/23V5IRT,2016-06-21 00:00:00,photo,55,50,38,143
52150999700,"Thinking about Rory and Lorelai? Don't worry, these images will help tide you over before Gilmore Girls returns to Netflix later this year.",2016-06-23 03:43:00,link,36,31,34,101
18807449704,Just incredible,2016-06-20 06:30:00,link,23,47,37,107
25902406772,Ingram to the LA Lakers???,2016-06-22 11:56:39,link,137,59,43,239
25902406772,"Three teams advance from the group in the end, but Portugal didn't secure a top two finish.",2016-06-22 13:47:21,link,125,46,45,216
112638779551,"""We thought that was the only thing we could do."" United States Golf Association - USGA's Jeff Hall on notifying Dustin Johnson about a possible penalty. #USOpen",2016-06-19 17:42:39,video,91,69,36,196
10513336322,"""So much heat, so much coverage, and still such a grey mist of incomprehension.""",2016-06-19 06:00:00,link,5,46,33,84
25902406772,That was just too much Leo Messi for USA.,2016-06-21 22:10:56,link,193,96,35,324
5281959998,"It's hard to blame the British for casting an envious eye on Switzerland. But Switzerland's independence from the European Union may be ""an illusion.""",2016-06-23 15:40:00,link,157,100,11,268
95926963131,Selma Blair was enjoying some rest and relaxation with her ex Jason Bleick and their son prior to the incident.,2016-06-20 21:42:06,link,167,39,49,255
18807449704,From 48 Hours to Sword and Scale,2016-06-23 05:30:00,link,42,15,39,96
13652355666,What you missed at America's most exclusive food festival. http://usat.ly/28II7Uf,2016-06-20 19:25:00,video,133,65,50,248
52150999700,This is not your average Ozzy Osbourne music tour. 🚘,2016-06-15 00:23:00,link,13,52,40,105
86680728811,Baltimore woman and her baby in critical condition after she was shot while pregnant.,2016-06-21 13:48:32,link,81,68,44,193
86680728811,"Many women pay thousands for the wedding dress of their dreams. These women, contestants in the annual Toilet Paper Wedding Dress competition, created stunning dresses that cost pennies to make. http://abcn.ws/1Um71XG",2016-06-17 14:34:00,photo,59,93,43,195
7245371700,What is Juneteenth? Here is why today is a historic day worth celebrating for African-Americans.,2016-06-19 09:23:25,link,95,45,47,187
5281959998,Britain is voting Thursday on whether to remain a member of the European Union. Follow our live blog for the latest updates.,2016-06-23 02:55:00,link,56,74,13,143
18807449704,"We need ""Your ex was stalking your profile last night"" notifications, Facebook",2016-06-23 07:59:47,link,116,80,13,209
25902406772,Adam Silver stands by the NBA's decision to suspend Draymond Green.,2016-06-16 14:06:38,link,57,52,6,115
75932763901,"Shortly after Yolanda Foster confirmed her departure from The Real Housewives of Beverly Hills, Bella Hadid makes a heartbreaking revelation—> http://bit.ly/1Uyc3lb",2016-06-16 15:00:00,photo,26,39,42,107
5281959998,"Oh, hello.

Recipe: http://nyti.ms/28MC2DZ

Photo: Andrew Scrivani for The New York Times",2016-06-21 21:55:00,link,197,24,35,256
86680728811,"FBI – Federal Bureau of Investigation Special Agent in charge Ronald Hopper on Orlando shooting: ""I would call it a hate crime. I would call it terrorism. It's both."" abcn.ws/1U9OLOY",2016-06-15 13:10:23,video,4,65,47,116
86680728811,California lawyer who prosecuted the former Stanford University swimmer convicted of sexually assaulting an unconscious woman sponsors legislation to toughen mandatory sentencing.,2016-06-23 00:19:10,link,151,21,11,183
13652355666,"""I don't know if the person walking me home is a rapist — but Stanford does.""",2016-06-17 18:21:00,link,191,15,29,235
5281959998,"Updated: A Democratic sit-in on the House floor demanding votes on gun-control legislation led to a remarkable scene of pandemonium as Speaker Paul Ryan was shouted down when he tried to regain control.

Read more: http://nyti.ms/28OTyqu

Photo: Representative John Yarmuth, via Associated Press",2016-06-22 21:24:37,photo,30,29,22,81
10513336322,"""We found it incredible that a law firm could be bragging about the fact that they had taken away provision from a child.""",2016-06-23 06:00:00,link,196,62,6,264
25902406772,"The internet sees all, RG3.",2016-06-21 17:09:32,link,102,20,16,138
112638779551,"LeBron James has pulled the Cleveland Cavaliers back from the dead with two of the best performances you'll ever see. ""Clutch"" is an understatement, says Dieter Kurtenbach:",2016-06-17 00:32:11,link,9,89,13,111
10606591490,"""You just have to start with yourself, you can't look at these retouched magazines.""",2016-06-24 08:30:30,link,2,6,36,44
10513336322,Buzzing.,2016-06-17 12:20:00,link,45,36,28,109
18807449704,This man has totally had it.,2016-06-22 08:12:41,link,148,26,23,197
112638779551,"20 years ago, Kobe Bryant was selected 13th in the NBA draft. These were the 12 players picked before him.",2016-06-23 17:13:59,video,74,66,31,171
7245371700,Beyoncé did this right.,2016-06-15 10:31:59,link,177,45,32,254
13652355666,We've reached it. That awkward moment when the billionaire candidate's campaign is in financial distress.,2016-06-21 18:10:00,link,128,87,16,231
52150999700,"Including one about Facebook's 1500 new, diverse emojis... 🙊",2016-06-16 07:44:00,link,51,86,44,181
13652355666,Our hearts are with Orlando.,2016-06-15 18:25:01,photo,143,46,48,237
95926963131,"When the officer finally remembered he had left Inka in the car, he found her dead. (via PEOPLE Pets)",2016-06-18 12:40:07,link,141,93,48,282
10513336322,Leicester's title defence begins at home to Hull on 13 August while Mourinho will travel to Bournemouth in his first game in charge Manchester United.,2016-06-15 03:11:26,link,109,11,18,138
52150999700,Lindsay Lohan is poised to make a return to music! 🎵,2016-06-24 01:34:00,link,76,82,32,190
5281959998,"Chris Mosier has long been an advocate for LGBT people in sports. 
Posing nude for ESPN The Magazine felt like another form of activism: ""It is a great opportunity to break the misconceptions or stereotypes people have about trans bodies.""",2016-06-23 13:35:00,link,120,71,32,223
86680728811,"JUST IN: Family of 2-year-old boy who died in alligator attack issues statement: ""Words cannot describe the shock and grief our family is experiencing over the loss of our son...we are devastated."" http://abcn.ws/1OsUhPQ",2016-06-16 13:56:09,link,65,38,34,137
112638779551,This is at least three straight years that Kevin Durant has schooled the kids at his camp. When will they learn?!,2016-06-21 17:13:28,link,128,55,38,221
7245371700,A father-daughter duo head to Bonnaroo Music and Arts Festival and discover Walt Whitman + J.Cole are more alike than not.,2016-06-15 20:10:55,link,108,11,36,155
112638779551,"It turns out Valérie "" TroUbLe"" Létourneau had a serious wardrobe malfunction during her UFC fight last weekend.",2016-06-22 14:58:14,link,82,55,15,152
52150999700,Even Jennifer Lawrence had to start somewhere.,2016-06-20 03:06:00,link,31,8,6,45
7245371700,Taking a stab at rounding up everything that happened in the deadliest Game of Thrones episode to date.,2016-06-20 10:12:36,link,188,81,28,297
7245371700,Your DAD Drake dresses like your actual dad.,2016-06-17 08:28:44,link,86,58,48,192
5281959998,"""It looked like somebody ripped my daughter's neck off and stitched it back together.""",2016-06-17 11:56:58,link,159,83,34,276
52150999700,Chewbacca Mom has officially made it. 💯  👏🏼,2016-06-19 15:24:00,link,22,100,6,128
10606591490,Should the U.K. stay or should it go?,2016-06-23 04:30:03,link,47,53,10,110
18807449704,That's some hangover!,2016-06-15 08:32:00,link,85,66,4,155
86680728811,"""Whatever it takes to sell a home!""",2016-06-21 20:11:54,link,89,26,45,160
7245371700,Teen Wolf star Tyler Hoechlin is trading in his fangs for a cape to play Superman.,2016-06-16 18:45:42,video,172,54,12,238
5281959998,Breaking News: 3 New York City police officials have been arrested in a significant widening of the inquiry into the mayor's fund-raising.,2016-06-20 06:41:08,link,36,37,2,75
7245371700,"""What can be done now, though, is to start laying the groundwork for policies that will stem the flow of weapons.""",2016-06-21 00:25:08,link,195,6,33,234
5281959998,"We might feel that we're getting by fine on less sleep, one doctor days, but we're deluding ourselves.",2016-06-19 21:55:00,link,5,86,6,97
13652355666,"BREAKING: Searchers have spotted the wreckage of EgyptAir Flight 804, which plunged into the Mediterranean Sea with 66 people board, Egyptian authorities announced Wednesday.",2016-06-15 15:24:00,link,60,7,25,92
10606591490,The victims are usually hacked to death in broad daylight.,2016-06-20 03:00:20,link,99,9,39,147
7245371700,Her super candid live video has me smiling ear to ear.,2016-06-22 23:25:39,link,153,23,15,191
95926963131,Park officials did little to call attention to the lightning-fast attack that occurred at the Disney's Grand Floridian Resort & Spa.,2016-06-16 13:37:05,link,17,4,40,61
7245371700,What can students do when the schools themselves are the bullies?,2016-06-23 18:21:08,link,113,52,15,180
52150999700,Jason Statham is BACK and intense as ever in Mechanic: Resurrection. 😱,2016-06-23 17:36:00,link,67,98,9,174
112638779551,Could Barack Obama go from running the country to running an NBA team?,2016-06-22 23:23:08,link,96,53,18,167
18807449704,Squirrels: They're just like us.,2016-06-24 09:36:56,link,59,61,43,163
95926963131,Kris Jenner is officially off momager duty!,2016-06-18 13:20:05,link,71,47,28,146
25902406772,That's a good cup of coffee.,2016-06-19 10:59:35,link,58,45,44,147
112638779551,Watch Dallas Cowboys RB Ezekiel Elliott blow by a helpless defender.,2016-06-16 12:36:32,link,138,4,31,173
25902406772,Not every NFL first-round pick is signed.,2016-06-16 19:31:03,link,65,85,31,181
86680728811,"Prince William makes impassioned plea against cyberbullying: ""Bullying is bullying, wherever it happens."" http://abcn.ws/21rd5jB",2016-06-17 18:25:16,link,148,44,20,212
10606591490,"""She didn't get defensive about her behavior or make excuses for her actions.""",2016-06-23 23:00:08,link,125,71,39,235
75932763901,"CONGRATS! Just a few months after welcoming baby Saint, Kanye West makes the announcement we've all been waiting for! —> http://bit.ly/237pWZJ",2016-06-15 06:01:00,photo,123,75,11,209
10606591490,Kelly Clarkson has a big announcement to come.,2016-06-21 21:00:18,link,62,100,45,207
25902406772,"Craig Sager, you are amazing.",2016-06-16 20:46:13,video,146,85,5,236
10606591490,The oceans are in danger.,2016-06-21 01:30:06,link,27,94,10,131
112638779551,One of the Cleveland Browns' most recognizable quarterbacks was invited to the Cleveland Cavaliers' championship parade.,2016-06-22 00:29:32,link,106,44,3,153
10606591490,There have been at least 82 shootings since 1982.,2016-06-16 09:00:03,link,125,90,46,261
112638779551,The Cleveland Cavaliers might not have one of their key pieces back next season.,2016-06-15 18:06:33,link,53,25,47,125
52150999700,Alexander Skarsgård and Michael Peña are ready to kick some ass. 👊🏼,2016-06-20 21:16:00,link,90,14,31,135
10606591490,"He said the Brexit vote is a ""great thing.""",2016-06-24 04:00:20,link,16,20,12,48
75932763901,"This is what Kim Kardashian West looked like when she was pregnant with Saint. Today, she's back down to her pre-baby weight — and we can't believe how awesome she looks! —> http://bit.ly/1UVxgS9",2016-06-15 19:00:03,photo,172,70,24,266
25902406772,The injured Minnesota Twins hurler isn't taking his missed time lightly.,2016-06-22 20:01:38,link,175,24,25,224
95926963131,Beaches are closed after an alligator dragged a toddler into the man-made Seven Seas Lagoon at Walt Disney World.,2016-06-15 11:24:03,link,118,71,36,225
25902406772,U.S. Soccer is advancing.,2016-06-17 00:18:14,link,142,81,16,239
7245371700,"Keep them coming, Kanye.",2016-06-17 03:32:45,link,193,32,43,268
75932763901,PLASTIC SURGERY?! Fans are accusing Natalie Portman of getting work done to her face — and when you see the photos you'll understand why —> http://bit.ly/1rtHamc,2016-06-17 16:00:00,photo,8,49,39,96
112638779551,Ángel Pagán's glove robbed him of the best catch of 2016.,2016-06-21 07:41:22,link,181,85,16,282
86680728811,"ABC News' David Muir asked Donald J. Trump why so many Trump products are made overseas. ""Unfortunately my ties are made in China."" http://abcn.ws/28R4N0N",2016-06-21 17:26:54,video,133,3,16,152
75932763901,BACK TOGETHER? See which former couple is giving things another go —> http://bit.ly/292M7fY,2016-06-24 17:30:00,photo,11,33,49,93
7245371700,Come visit Wonderland!,2016-06-16 15:10:52,photo,139,15,39,193
52150999700,Demi Lovato is saying goodbye to Instagram and Twitter with a strong message to fans.,2016-06-21 15:34:00,link,180,23,12,215
112638779551,Steven Wright -- the Boston Red Sox's newest knuckler -- now leads the AL with a 2.01 ERA.,2016-06-21 14:03:58,link,177,41,45,263
52150999700,Alexander Skarsgård's intense preparation for Legend of Tarzan sounds impossible. 😱🔥,2016-06-17 10:33:00,link,75,77,39,191
18807449704,The Tonight Show Starring Jimmy Fallon just got schooled by Blake Lively in Harry Potter trivia.,2016-06-21 16:30:00,link,151,97,7,255
52150999700,Anthony Kiedis of the Red Hot Chili Peppers is a SUPER dad! 👏👏👏,2016-06-16 23:15:00,link,18,3,34,55
7245371700,"Such a beautiful tribute, Christina Aguilera.",2016-06-17 10:59:00,link,169,39,40,248
95926963131,"Angelika Graswald allegedly sabotaged her fiancé's kayak, causing him to drown to death. (via People True Crime)",2016-06-20 15:28:04,link,148,44,20,212
5281959998,From The New York Times Opinion Section: How much collateral damage could Donald J. Trump inflict on the Republican Party?,2016-06-23 15:55:00,link,43,79,17,139
7245371700,Did your favorite new hip-hop artist make the cut?,2016-06-18 14:38:07,link,52,69,40,161
86680728811,"Father shocked to discover that his two toddlers had covered their bedroom in paint. ""Have kids, they say. It'll be fun, they say."" http://abcn.ws/28Nfhif",2016-06-22 17:54:01,video,62,85,15,162
112638779551,An Andrew Landry victory at Oakmont Country Club would be the greatest U.S. Open Championship in history. #USOpen,2016-06-19 10:19:03,video,12,38,14,64
86680728811,"94-year-old Reinhold Hanning, who was a guard at Auschwitz from 1942 to 1944, has been found guilty of being an accessory to the murder of at least 170,000 people. http://abcn.ws/1OulzW5",2016-06-17 09:52:48,link,67,97,12,176
7245371700,Beyoncé did this right.,2016-06-17 02:24:09,link,28,54,23,105
5281959998,"Angelika Graswald asked an investigator who ""Miranda"" was — after she had been read her Miranda rights, according to testimony.",2016-06-21 22:25:00,link,34,33,15,82
7245371700,Who's your pick?,2016-06-21 08:06:53,link,163,13,49,225
112638779551,Michael Bisping vs. Dan Henderson 2 might be a possibility after all.,2016-06-22 16:20:14,link,126,62,45,233
25902406772,"With the first pick in the draft, the Philadelphia 76ers took a phenom.",2016-06-23 18:37:37,photo,132,21,35,188
10606591490,Cue the memes.,2016-06-20 15:00:59,link,66,63,1,130
112638779551,"Relive the best moments of a great golf weekend in Virtual Reality using the @nextvr app!

It's like being there.",2016-06-20 20:37:25,link,45,28,35,108
25902406772,Narrowing down Florida State Seminoles Football's Mount Rushmore was mighty hard.,2016-06-15 12:42:39,link,7,18,21,46
52150999700,SPECIAL DELIVERY: The exclusive new trailer for #STORKS is here! Watch now: http://share.ew.com/ey0JQP3,2016-06-16 08:01:49,video,65,2,34,101
5281959998,"For one day and night, the hottest cable drama was on C-SPAN.",2016-06-23 11:55:00,link,175,10,30,215
52150999700,Late Night with Seth Meyers proposed Megan Fox for the role of First Lady. 😂,2016-06-23 09:25:00,link,136,48,41,225
95926963131,It's been a month since 7-month-old Bentley Yoder underwent surgery to place his brain back into his cranium.,2016-06-23 12:04:05,link,193,48,31,272
112638779551,The 1997 Cleveland Indians almost ended the title drought for Cleveland. The seventh game went on and on before the Florida Marlins won the World Series in 11 innings.,2016-06-19 11:46:38,link,169,11,39,219
86680728811,"Swiss adventurer Bertrand Piccard takes off from New York City inside the Solar Impulse, a solar-powered plane, for his historic four-day journey across the Atlantic Ocean.",2016-06-20 09:16:24,link,98,38,24,160
10606591490,"""When Clinton is tough, a characteristic many see as unfeminine, it doesn't feel right, so she must not be authentic.""",2016-06-23 08:30:21,link,153,90,18,261
52150999700,"Anton Yelchin's Star Trek co-stars are ""shocked and numb"" after the actor's death.",2016-06-19 18:34:49,link,128,6,41,175
52150999700,The Late Night with Seth Meyers team has officially put the ball back in Donald J. Trump's court.,2016-06-16 08:38:00,link,199,30,47,276
5281959998,"College campuses are struggling to balance respectful discussions about race and diversity with holding open conversations on controversial topics. Nicholas Christakis of Yale University, Annette Gordon-Reed of Harvard Law School and Marvin Krislov, president of Oberlin College, are talking with Nikole Hannah-Jones of The New York Times Magazine about the best framework for frank — and potentially explosive — conversations on campus?",2016-06-21 08:35:57,video,134,5,26,165
95926963131,Justice League superheroine Wonder Woman turns 75 this year and she hasn't aged a day.,2016-06-15 08:28:06,link,47,55,7,109
25902406772,The Golden State Warriors coach could be losing some duckets.,2016-06-17 00:06:41,link,20,78,19,117
7245371700,Can we get a Miguel x Justin Timberlake song soon ?,2016-06-18 23:56:11,link,67,37,13,117
25902406772,Game 7 is upon us and the predictions.. are.. IN.,2016-06-18 18:31:52,link,150,30,5,185
112638779551,"Smylie Kaufman is getting ready for tomorrow's U.S. Open Championship! 

(via PROcast)",2016-06-15 13:46:56,video,158,3,34,195
7245371700,I'm still trying to figure out what a ~flexicution~ is.,2016-06-15 01:01:08,link,67,13,35,115
18807449704,Nikesh Arora decided to take a slightly different approach to the usual executive departure announcement.,2016-06-22 02:00:00,link,157,58,13,228
25902406772,"The Brow has a new Buddy.

Say hello, New Orleans Pelicans fans.",2016-06-23 19:14:08,photo,2,84,42,128
10606591490,Change the way you use Facebook.,2016-06-16 23:30:12,link,178,31,19,228
75932763901,"DEVASTATING — our thoughts are with her famous mother, who revealed she recently suffered a miscarriage. Life & Style Weekly has the heartbreaking details: http://bit.ly/28MApso",2016-06-22 04:45:00,photo,2,22,41,65
75932763901,Remember Grant Holmquist who played baby Carlos in the movie 'The Hangover'? Well — he is all GROWN UP and you need to see what he looks like today —>http://bit.ly/1OXoMuE,2016-06-19 18:00:00,photo,28,79,20,127
52150999700,Ed O'Neill says a Married with Children reunion is not likely: http://share.ew.com/WA8d0XQ,2016-06-16 20:08:00,video,127,56,34,217
112638779551,"""I am just so ready to go win a championship right now."" -- Joe Haden says the Cleveland Cavaliers have motivated the Browns to go win a Super Bowl.",2016-06-20 14:31:36,link,140,38,22,200
25902406772,Update: Wade Phillips finally gets the right ring.,2016-06-17 09:51:57,link,13,41,27,81
7245371700,Remember when Tom Hiddleston told us he thought Taylor Swift was 'amazing'? INTERESTING. (Via MTV UK),2016-06-16 22:14:27,video,63,79,19,161
7245371700,"10 years since the release of her first country single, and Taylor Swift's anthems of confessional heartbreak have never been more timely.",2016-06-21 13:48:56,link,15,38,7,60
95926963131,"Happy birthday, Blake Shelton—and thank you for providing us with endless laughs on Twitter. 🎉",2016-06-18 17:40:10,link,84,80,23,187
95926963131,Pretty Little Liars costume designer Cameron Dale takes us on a tour of the costume department! (via People Video),2016-06-22 01:00:00,video,13,1,19,33
10513336322,"Dads also experience a bonus for having two or more children, above and beyond that of being a father of one child. The findings are in stark contrast to the experience of working mums.",2016-06-19 06:20:00,link,32,74,25,131
25902406772,Stephen Curry knows what he has to do to win Game 7.,2016-06-18 20:56:42,photo,160,23,37,220
112638779551,Toronto Blue Jays slugger will be in a walking boot until he is re-evaluated in two weeks.,2016-06-21 17:13:57,link,38,59,5,102
95926963131,The Real Housewives of Orange County star is choosing to see the positive.,2016-06-17 21:40:13,link,133,96,42,271
52150999700,The Star Wars actor's new film will address the systemic racism in Detroit.,2016-06-21 14:54:00,link,88,66,38,192
112638779551,What do the leaders need to pull off over the final 18 holes to walk away with the U.S. Open Championship trophy? We breakdown what needs to happen.,2016-06-19 09:19:43,link,90,76,27,193
13652355666,"""No one should be bullied for their sexuality.""",2016-06-15 10:21:00,link,189,33,1,223
18807449704,"Fashion has a new squad, and it has nothing to do with Taylor Swift.",2016-06-22 18:50:57,link,89,24,14,127
13652355666,Can a 70-year-old man change? (via USA TODAY Opinion),2016-06-23 14:12:00,link,101,97,5,203
52150999700,Teen Wolf star Tyler Hoechlin is joining the elite Superman club for Supergirl! 🙌,2016-06-16 11:03:04,link,83,2,26,111
75932763901,Find out if Blac Chyna will be a pregnant bride!,2016-06-22 17:30:00,link,137,37,26,200
10513336322,"""If the Brits are against all the regulations made in Brussels, I think the Norway model is not the solution. Being an EEA member means you are not at the table, yet you have to take in much of the legislation. When you listen to the debate going on on the leave side in Britain, it is hard to imagine that this should be a solution to their problems.""",2016-06-16 05:20:00,link,184,99,37,320
25902406772,Tony Parker is a true team player for the San Antonio Spurs.,2016-06-18 13:06:14,link,104,68,44,216
25902406772,You can't stop LeBron James.,2016-06-16 21:16:29,link,8,77,45,130
112638779551,David Blatt opens up about his firing and rocky relationship with LeBron James.,2016-06-16 14:36:42,link,96,15,5,116
5281959998,Hillary Clinton plans to portray Donald J. Trump as an uncaring and unscrupulous businessman whose policies would lead to a new financial crisis.,2016-06-21 04:55:00,link,112,33,4,149
10513336322,See the EU referendum results region by region as they come in.,2016-06-23 16:20:00,link,157,27,3,187
75932763901,PREGNANT?! Click here to see Kylie Jenner's announcement —> http://bit.ly/28L16uk,2016-06-21 17:30:00,photo,133,83,40,256
75932763901,NO WAY! This star was married SEVEN times before finally finding the love of his life! Find out who (via Closer Weekly) —> http://bit.ly/28Tdifn,2016-06-23 22:30:00,photo,174,12,48,234
10606591490,You may want to rethink scheduling that 5 p.m. happy hour.,2016-06-18 07:30:17,link,102,28,27,157
10513336322,"""'Governments paying ransoms doesn't have any effect on whether or not people are taken hostage. Frequently what happens is it has an effect only on whether or not people go home alive.""",2016-06-17 12:00:01,link,187,94,8,289
18807449704,What's going on here?!,2016-06-19 16:50:59,link,199,94,12,305
86680728811,"When asked if there would be a role for eldest son Donald Jr. and daughter Ivanka in The White House, Donald J. Trump said 'probably not.'",2016-06-21 23:14:06,link,1,26,35,62
5281959998,"Smokers may not realize they have lung damage, because tests can fail to detect it.",2016-06-20 09:55:00,link,35,15,34,84
25902406772,Dwayne The Rock Johnson almost made some SERIOUS waves.,2016-06-23 12:01:34,link,68,70,19,157
25902406772,It will be Argentina-USA for a spot in the Copa America finals.,2016-06-18 20:05:21,link,33,99,9,141
86680728811,President Barack Obama wheels up aboard Air Force One to Orlando. http://abcn.ws/23e5mqH,2016-06-16 09:58:31,video,35,52,22,109
10513336322,"Referendums in the UK aren't, strictly speaking, legally binding.",2016-06-23 17:00:00,link,31,88,40,159
52150999700,Liam Hemsworth is also down to join Curb Your Enthusiasm's new season!,2016-06-16 15:01:00,link,107,57,4,168
86680728811,We're only halfway through June and the nation had already witnessed 135 mass shootings before the gunman in Orlando killed at least 49 people.,2016-06-15 19:51:02,link,176,40,31,247
10513336322,Clara Bow's biography could have been a fairy story but instead it is a cautionary tale...,2016-06-22 06:00:00,link,3,11,8,22
95926963131,The couch and a glass of wine—it's not just for humans anymore. (via PEOPLE Pets),2016-06-21 22:00:09,link,85,41,15,141
18807449704,"The salon will only shave the pets, and does not dye their fur.",2016-06-21 05:03:03,link,120,59,49,228
52150999700,"Ricky Gervais' The Office character is BACK, and the trailer is hilarious! 😂",2016-06-17 09:42:00,link,135,49,22,206
52150999700,This is going to be so beautiful. ❤️,2016-06-15 15:13:01,link,146,100,10,256
10513336322,"Jay Rayner: ""The best non-meat cookery does not have a meaty twin. It's not an echo of the real thing, the recipe contrived by substitutions and arch compromise and regret. It is itself.""",2016-06-19 05:40:00,link,57,6,33,96
10606591490,"Seth Meyers said Donald J. Trump has hit a ""new low.""",2016-06-15 14:30:04,link,78,16,5,99
52150999700,Kerry Washington wasn't always handling things on Scandal.,2016-06-16 04:07:00,link,51,79,36,166
112638779551,"Imagine a red carpet whenever you exit your car. No valet? No problem. The Rolls-Royce Motor Cars 103EX concept is awesome.

Daryl Motte for @TheBuzzer.",2016-06-21 13:49:04,video,4,79,35,118
112638779551,CM Punk will make his UFC debut in September http://foxs.pt/28PMYQy,2016-06-23 18:44:15,video,13,17,18,48
95926963131,Tonight's Game of Thrones was epic and satisfying! 😱 🙌,2016-06-19 21:17:01,link,118,78,15,211
13652355666,Dreams really do come true.,2016-06-18 22:10:00,link,69,78,3,150
75932763901,"Kim Kardashian West nearly broke the internet with this nude selfie — and if you think THIS is racy, just wait until you see her sexy new snap: http://bit.ly/28NfEIb",2016-06-23 04:45:00,photo,62,95,31,188
25902406772,Joba hasn't forgotten the midges.,2016-06-21 17:36:01,link,37,38,19,94
7245371700,She's like Lizzie McGuire but all grown-up.,2016-06-19 06:16:02,link,104,67,26,197
13652355666,The Air Force's elite Thunderbird jets returned to the sky Saturday two weeks after a crash in Colorado.,2016-06-19 02:10:06,link,3,6,47,56
25902406772,Royals right-hander Yordano Ventura's suspension has been reduced to eight games.,2016-06-18 18:17:39,link,151,3,13,167
13652355666,House Dems vow to continue their sit-in when the House reconvenes after its July 4 break.,2016-06-23 10:15:00,link,70,62,45,177
10513336322,"""Looking at the statistics, you might think I should be dead. And yet here I am today, a sober, emancipated, successful and happy woman.""",2016-06-21 08:40:00,link,24,27,19,70
7245371700,Totally forgot they were in Cow Belles.,2016-06-23 05:18:33,link,192,55,35,282
86680728811,WATCH: President Barack Obama's full remarks after meeting with Orlando shooting survivors and families of victims. http://abcn.ws/23e5mqH,2016-06-16 16:10:44,video,24,86,10,120
86680728811,"Kentucky community rallies together to support a beloved, friendly neighborhood tortoise who's been hospitalized since he was accidentally run over by a car.",2016-06-22 16:56:10,link,178,61,14,253
112638779551,Derek Jeter sat down with Barack Obama to talk about all things ranging from childhood to retirement.,2016-06-22 12:31:09,link,189,30,41,260
18807449704,😂 😂 😂,2016-06-15 22:32:18,link,81,100,45,226
52150999700,Frank Ocean has penned an incredibly powerful note about the Orlando shooting: http://share.ew.com/fJc8Ckd ❤️,2016-06-21 17:25:00,video,49,67,23,139
5281959998,"Garrison Keillor has managed to stay a mystery, even to people who know him well.",2016-06-16 12:16:48,link,115,64,25,204
7245371700,"In the end, Prince + Batman weren't so different after all.",2016-06-20 14:06:28,link,17,2,33,52
7245371700,She was stopped by airport security.,2016-06-17 15:35:05,link,28,63,46,137
7245371700,Tfw when Orange Is the New Black makes you feel all the feels.,2016-06-16 19:18:06,link,154,28,43,225
86680728811,"The Golden State Warriors are now up against an all-time great player who is very much in the present, trying to make his team the first to come all the way back from a 3-1 deficit in the NBA Finals: http://abcn.ws/1UChZdd",2016-06-18 08:57:33,link,79,92,30,201
112638779551,"#NASCAR veteran Mike Wallace hospitalized after three men allegedly assaulted him following a Rascal Flatts concert in Charlotte, NC.",2016-06-19 13:05:53,link,188,16,23,227
112638779551,Dez Bryant revealed why the Cowboys won't put Ezekiel Elliott through any sort of hazing.,2016-06-22 13:17:35,link,76,13,42,131
18807449704,"""Goodbye UK""",2016-06-24 04:34:45,link,177,40,27,244
10606591490,"Blake Lively: ""You can go on our website and we will give you some of our children.""",2016-06-21 09:00:04,link,58,72,26,156
112638779551,Highly touted free agent Will Brooks signs with the UFC and faces Ross Pearson at The Ultimate Fighter Finale on July 8,2016-06-15 14:30:20,link,116,25,23,164
10513336322,"""A lot of people supported us, and it was simple. All we planned to do was go to school bra-less. We didn't want to harm anybody. We didn't want to make the administration upset. It was for us.""",2016-06-18 13:20:00,link,133,25,46,204
25902406772,LeBron James could be playing for his legacy tonight.,2016-06-16 08:13:06,link,171,92,14,277
95926963131,Bernie Sanders is with her—Hillary Clinton.,2016-06-16 22:06:06,link,12,82,5,99
25902406772,Could Dirk Nowitzki really leave the Dallas Mavericks?,2016-06-21 19:10:07,link,124,35,26,185
5281959998,Exclusive: An Olympic athlete from Russia emailed the World Anti-Doping Agency about Russia's widespread cheating. The agency did nothing.,2016-06-15 14:23:45,link,142,81,18,241
86680728811,"Police recovered seven guns — including rifles and handguns — as well as four knives, 10 clips of ammunition, body armor and a military-grade helmet, law enforcement source says.",2016-06-21 20:34:30,link,21,4,37,62
95926963131,"These potato-shaped rodents have the perfect oval faces and expressive eyes for wigs, glasses, capes and more. (via PEOPLE Pets)",2016-06-22 05:00:30,link,90,44,41,175
112638779551,"Dustin Johnson may (or may not) have a penalty assessed after his final round, and his fellow competitors are not happy.",2016-06-19 18:32:35,link,188,37,3,228
52150999700,The actress has released a statement about the in-flight incident.,2016-06-21 18:49:50,link,88,59,39,186
5281959998,Here's what the Supreme Court decided on immigration and affirmative action today and what it means.,2016-06-23 14:55:00,link,127,41,2,170
52150999700,"That's right: the last time Dwayne The Rock Johnson ate candy, George H. W. Bush was president.",2016-06-17 08:12:00,link,183,73,47,303
95926963131,"Our hearts go out to the family of 2-year-old Nebraskan boy, Lane Graves. ❤️",2016-06-15 20:52:23,link,53,27,46,126
13652355666,Hundreds waited in line for hours Saturday to get tattoos remembering the victims of Sunday's mass shootings at an Orlando nightclub.,2016-06-18 18:35:04,link,9,8,43,60
7245371700,"So, what was the real reason Donald J. Trump's campaign manager was fired?",2016-06-22 14:26:57,video,64,77,43,184
112638779551,"After skipping the first day of Miami Dolphins minicamp, Reshad Jones is back in the fold.",2016-06-15 11:13:25,link,52,37,13,102
112638779551,The former track star is in the midst of his sentencing hearing in South Africa's High Court.,2016-06-15 13:09:04,link,200,8,17,225
18807449704,Impressive. 👏 👏 👏,2016-06-18 12:05:00,link,4,49,31,84
25902406772,Shawn Porter and Keith Thurman are set to face off in the ring.,2016-06-20 13:18:31,link,119,56,21,196
86680728811,News of the continued record-breaking temperatures hits the same week that President Obama used Yosemite National Park as a backdrop to warn of the dangers of climate change: http://abcn.ws/1UEeanz,2016-06-19 15:18:43,link,72,30,32,134
52150999700,This PBS documentary will show Hamilton: An American Musical in a totally unique way! 🙏❤️,2016-06-23 19:20:00,link,4,23,18,45
95926963131,The shooter called 911 in the midst of his June 12 rampage.,2016-06-20 13:36:07,link,192,100,2,294
112638779551,It's good to be LeBron James right now.,2016-06-20 10:48:57,link,122,43,36,201
95926963131,The La Voz México finalist was shot and killed outside the Chicago performing arts school he owned. (via People True Crime),2016-06-19 11:20:08,link,168,98,8,274
13652355666,"""I think it was really important for him to be here.""",2016-06-17 02:05:00,link,92,3,26,121
112638779551,"If you think Stephen Curry throwing his mouthpiece late in Game 6 will mean he's facing a suspension for Game 7, that might not be so.",2016-06-17 00:02:05,link,18,32,38,88
112638779551,"Say hello to your new coach, LA Lakers fans.",2016-06-21 19:48:30,link,70,50,23,143
52150999700,The Dalai Lama's answer is NOT what we expected. 😂,2016-06-17 19:46:00,link,185,42,20,247
52150999700,The Lion King premiered in theaters 22 years ago today—hakuna matata!,2016-06-15 22:33:00,link,190,87,45,322
112638779551,Thrilling finish as Los Angeles Dodgers sweep Washington Nationals,2016-06-23 03:02:53,link,190,40,49,279
5281959998,Managing Type 2 diabetes is much harder if you can't afford vegetables you're told to eat.,2016-06-17 12:25:00,link,191,61,36,288
10606591490,Drivers were warned of a defect in the model.,2016-06-21 05:30:29,link,59,30,24,113
13652355666,"The summer you wish you could have, and the summer you'll probably end up having.",2016-06-22 14:15:00,link,76,4,49,129
10606591490,It could be used to deny Trump the nomination,2016-06-18 16:00:23,link,45,14,47,106
10606591490,"After five long years of torment, Sansa Stark has finally come into her own.",2016-06-20 12:30:26,link,25,66,43,134
25902406772,"James Conner has already started using his story to help with cancer awareness, as he promised during his treatments.",2016-06-20 15:05:49,link,155,14,48,217
25902406772,The Philadelphia 76ers are on a mission.,2016-06-21 14:56:58,link,126,29,24,179
25902406772,Martellus Bennett is ready to suit up for the New England Patriots.,2016-06-16 10:30:23,link,20,54,15,89
7245371700,Glad that's settled.,2016-06-23 20:28:43,link,119,50,21,190
13652355666,Misty Lee Wilke had a sexual relationship with the man.,2016-06-16 11:26:13,link,22,13,6,41
86680728811,"President Obama greets the Dalai Lama ahead of a private White House meeting, where the Tibetan spiritual leader expressed condolences over the Orlando shooting: http://abcn.ws/1rqqTi3",2016-06-15 15:12:45,link,135,19,37,191
18807449704,The UK prime minister has just announced that he will resign,2016-06-24 04:07:55,link,133,35,8,176
10513336322,"""Later, over a large glass of whisky in the green room, she asked why everyone had laughed when she said she was 'always on the job'.""",2016-06-20 10:00:00,link,89,6,26,121
86680728811,"Tens of thousands of people on the Japanese island of Okinawa protested Sunday against the presence of U.S. military bases there, many wearing black to mourn the rape and killing of a local woman in which an American contractor is a suspect. http://abcn.ws/1ScNqEM",2016-06-19 21:54:01,link,54,89,35,178
13652355666,"Young simply tweeted, ""Single.""",2016-06-19 21:07:01,link,148,1,13,162
18807449704,Kim Kardashian West is leaving very little to the imagination.,2016-06-15 16:16:15,link,175,63,15,253
52150999700,Survivor host Jeff Probst weighs in on that controversial 'Kaoh Rong' finish: http://share.ew.com/eOUmgxR 😱,2016-06-15 18:09:01,video,132,73,12,217
10513336322,"This year, we've judged EA - Electronic Arts, Bethesda Game Studios, Microsoft, Ubisoft, and Sony for the diversity of their speakers and of the games and characters on show. How do they compare?",2016-06-15 05:50:21,link,157,88,24,269
5281959998,"Donald J. Trump's style of playground humor is appealing to people (specifically, white men) who are feeling that they aren't in on the joke. Read on in The New York Times Opinion Section.",2016-06-21 05:55:00,link,25,98,15,138
52150999700,Here's how Ugly Betty made the one and only Adele famous: share.ew.com/AUPOm3f 🙌🏻,2016-06-16 01:04:00,video,62,7,1,70
86680728811,"Speaking in Atlanta on Wednesday, Donald J. Trump appeared to be fed up with leadership of the party he will likely lead into November.",2016-06-15 21:05:42,link,53,37,20,110
25902406772,The San Diego Chargers aren't exactly happy with Joey Bosa.,2016-06-15 13:28:27,link,166,33,10,209
95926963131,The four votes come after Senator Chris Murphy filibustered for nearly 15 hours.,2016-06-20 19:35:34,link,23,55,27,105
86680728811,"With Olympic Games weeks away, athletes are facing a difficult decision to either skip Rio de Janeiro over concerns about Zika or attend the games and risk getting sick.",2016-06-22 22:02:54,link,54,92,9,155
52150999700,"This is MAJOR, Outlander fans! Here's your exclusive first look at important new characters Brianna and Roger: http://share.ew.com/GEUlq6J 👌🏼",2016-06-22 12:10:26,video,73,57,15,145
5281959998,"It started as a lone voice for gun control. But then the message was amplified to millions, with #filibuster and #holdthefloor.",2016-06-16 02:29:53,link,89,57,21,167
25902406772,Leicester City Football Club are keeping Jamie Vardy.,2016-06-23 12:57:04,link,96,35,32,163
86680728811,"Plane spotting near the end of the runway at Ronald Reagan Washington National Airport, just a few miles south of downtown Washington, D.C.",2016-06-17 09:09:33,video,123,5,19,147
18807449704,Whoops!,2016-06-23 15:00:00,link,62,1,49,112
18807449704,"Absolutely vile.
(via Mashable UK)",2016-06-16 08:18:19,link,145,46,47,238
75932763901,RIP! Our hearts are breaking to hear about the death of this young actor —> http://bit.ly/1YzwuQ9,2016-06-19 16:01:28,photo,187,95,30,312
95926963131,Kim Kardashian West  has already dropped her 60 lbs. of pregnancy weight. (via People Great Ideas),2016-06-15 08:06:03,link,131,20,19,170
25902406772,Johnny Manziel has had a rough couple of months.,2016-06-22 12:36:19,link,4,34,27,65
18807449704,The artist used a paintbrush and a tampon using her own menstrual blood to craft a portrait of Donald J. Trump.,2016-06-17 23:00:00,link,184,43,15,242
10513336322,"""Brexit led by Ukip and the Tory right will not make anything better: it will make them worse. Nigel Farage, Neil Hamilton, Boris Johnson, Michael Gove. They have fought all their lives to give more power to employers and less to workers. Many Brexiters are on record as wanting to privatise the NHS. They revelled in the destruction of the working-class communities and cultures capable of staging real revolt. They talk about defying the ""elite"". But they are the elite.""",2016-06-20 07:21:00,link,102,13,9,124
112638779551,"Strike a pose, Ángel Cabrera. El Pato is joining the stripe show. #LexusRCF #USOpen",2016-06-17 17:53:17,video,128,94,1,223
25902406772,James Shields imploded yet again on Saturday.,2016-06-18 19:57:44,link,100,99,9,208
112638779551,Shaquille O' Neal is always watching.,2016-06-22 08:07:27,link,15,3,28,46
86680728811,Cargo ship filled with junk from the International Space Station burns up as planned as it re-entered Earth's atmosphere.,2016-06-22 11:44:54,link,114,70,24,208
7245371700,Does it feel like President Obama has given one seven-year-long speech after mass shootings? (via Mic),2016-06-16 07:09:36,video,10,90,21,121
25902406772,Kyrie Irving and LeBron James are clicking for the Cleveland Cavaliers.,2016-06-16 21:13:03,link,174,87,13,274
95926963131,A new book details the actions Dr. Conrad Murray took in his then-patient Michael Jackson's final days.,2016-06-23 08:46:09,link,173,30,8,211
7245371700,"""The violence is, in some ways, inescapable... Joy alone will not grant anyone safety. It can, however, act as a small bit of fuel when the work of resistance becomes too much.""",2016-06-19 11:41:05,link,42,26,7,75
75932763901,"Just one month after the cheating rumors started, Sharon and Ozzy Osbourne's relationship just took another CRAZY turn!!! —> http://bit.ly/1UfvwUa",2016-06-18 11:15:00,photo,75,39,11,125
13652355666,Terrible.,2016-06-18 01:50:00,link,86,100,8,194
75932763901,"Congratulations, Candace Cameron Bure! Get the exciting news (via Closer Weekly) —> http://bit.ly/28QhMjy",2016-06-24 22:00:00,photo,105,84,44,233
7245371700,"""People often expect when they see us, because we're young girls, that we might be a bit more docile. They have this preconceived notion of what we're going to be like, and we like to challenge that.""",2016-06-16 18:50:29,link,6,79,16,101
25902406772,LeBron James has plenty of years left in the tank.,2016-06-15 18:10:41,link,143,75,7,225
10606591490,"Demi Lovato called Mariah Carey's behavior towards Jennifer Lopez ""nasty.""",2016-06-21 12:00:12,link,49,31,42,122
10606591490,"""It was absolutely horrific.""",2016-06-21 05:00:19,link,193,61,34,288
7245371700,Totally forgot they were in Cow Belles.,2016-06-21 18:29:18,link,41,80,41,162
5281959998,"""David Cameron, the British prime minister, has no one to blame but himself.""",2016-06-21 23:55:00,link,94,50,2,146
18807449704,We can't tell if this is adorable or terrifying or both.,2016-06-23 16:06:19,link,191,10,45,246
10513336322,"""When we're treating celebrities we have to go beyond our comfort zone. Celebrities demand much more than the average person and rightly so because they are in front of cameras and on the red carpet. But you have to know your limits. If you mess up, you have a problem.""",2016-06-17 11:20:00,link,44,34,28,106
13652355666,"More women are coming forward to publish their stories daily, determined to move the cycle of shame off of themselves and onto their rapists.",2016-06-21 15:19:07,link,150,51,1,202
5281959998,"""Their grief is beyond description,"" President Obama said after meeting with mourners of the Orlando shooting for 2 hours and laying bouquets of white flowers at a makeshift memorial nearby. He said he and Joe Biden had held grieving parents and told them, ""Our hearts are broken, too."" 

Read more: http://nyti.ms/1UbYcNX

Photo: Stephen Crowley/The New York Times",2016-06-16 18:55:00,photo,71,12,19,102
5281959998,Photos by more than 20 photographers explores dandyism in black communities around the world.,2016-06-17 18:55:00,link,168,39,39,246
10606591490,Celebrate Worldwide Knitting In Public Day in Bryant Park,2016-06-18 13:53:52,video,139,24,8,171
10606591490,What do you think of Kanye's new track?,2016-06-15 12:30:13,link,186,70,43,299
13652355666,"Prince had more ""secret"" children, siblings and distant cousins than anyone could dream.",2016-06-15 16:57:00,link,55,58,48,161
5281959998,"The number of women who have been infected with the Zika virus during their pregnancy in the continental U.S. has risen to 234, the CDC reports.",2016-06-16 15:55:00,link,61,83,14,158
7245371700,"HBD to my favorite sass princess, North West.",2016-06-15 17:20:57,link,109,64,47,220
10606591490,Hubble still has close to a decade of life left to it.,2016-06-16 07:30:12,link,138,61,3,202
18807449704,Hundreds form human chain to block Westboro protesters from Orlando victims' funerals.,2016-06-20 13:30:00,video,200,84,24,308
10513336322,"The US doesn't just have a mass shooting problem – it has an enormous, multifaceted gun violence problem. Why focusing America's gun control debate on mass shootings misses the point.",2016-06-21 09:00:00,link,126,30,34,190
7245371700,Keke Palmer dropped knowledge on the haters.,2016-06-19 19:45:07,link,45,3,19,67
112638779551,#RogerFederer's design for #Wimbledon includes ... sweatpants??? #NeedsMoreBlazer,2016-06-22 15:39:04,link,172,80,8,260
7245371700,Lil Wayne has returned to Twitter.,2016-06-15 07:39:25,link,64,43,11,118
52150999700,There's some major drama behind Leonardo DiCaprio's The Wolf of Wall Street character.,2016-06-17 18:39:00,link,49,97,46,192
18807449704,A pre-teen girl is at a unique moment in her life.,2016-06-19 05:00:00,link,115,47,41,203
10513336322,"Sara Pascoe: ""Do you remember the olden days when two pretty girls on Brookside had a snog and we all had to take a day off school from shock? If Beth Jordache's lady lip-locking was one small step, then every episode of Orange Is the New Black is a leap straight from Earth to the moon.""",2016-06-15 11:40:00,link,55,27,15,97
7245371700,"""What happened in Orlando, a scene of murder and mayhem, was terrorism, in that it was intended to make us feel terror, and to make LGBTQ people aware that being ourselves with one another is dangerous and to be avoided. 

But it won't work.""",2016-06-20 00:30:52,link,106,57,48,211
5281959998,"English nationalism is growing, and it is being encouraged by the EU referendum.",2016-06-16 03:00:39,link,162,20,13,195
18807449704,3. Know your weakness.,2016-06-20 02:00:00,link,30,55,27,112
7245371700,"""Shirley Chisholm laid the path for both Barack Obama and Hillary Clinton, but you rarely hear her name.""",2016-06-15 20:45:02,link,154,59,36,249
86680728811,Four people were killed in Arizona and millions more remain under a heat warning advisory following an intense heatwave that impacted several states.,2016-06-20 08:21:36,link,124,18,30,172
25902406772,Peyton Manning is simply a hard act to follow.,2016-06-22 15:13:09,link,189,80,22,291
52150999700,Meet two VERY important Outlander characters set to debut on the second season finale!,2016-06-22 08:36:00,link,160,19,34,213
86680728811,"Funeral held in Nebraska for 2-year-old Lane Graves, who was killed in a gator attack at Disney World.",2016-06-21 12:22:04,link,62,59,24,145
7245371700,"Beyoncé has fooled us all, again.",2016-06-19 02:35:19,link,41,29,6,76
10513336322,"""'If you haven't been to a phone-free show, you just don't know what you're missing.""",2016-06-23 04:00:00,link,94,49,36,179
18807449704,"In The Tonight Show Starring Jimmy Fallon's Donald J. Trump impersonation battle, everyone wins.",2016-06-23 13:00:00,link,96,65,31,192
18807449704,*packing bags*,2016-06-16 02:00:00,link,5,27,20,52
75932763901,OH NO! Find out which of these 'The View' stars is leaving the show for good (via Closer Weekly) —> http://bit.ly/1WRaUYf,2016-06-17 20:30:00,photo,67,67,25,159
10513336322,"""Tensions occur when people don't know each other, can't understand each other or can't communicate. If you give people the opportunity to connect with each other and work together, it's a lot more effective and efficient than doing it via the bureaucratic route.""",2016-06-16 11:18:40,link,31,7,28,66
18807449704,This is so adorable.,2016-06-15 10:30:00,link,145,37,24,206
95926963131,Senator Chris Murphy ends his 15 hour filibuster with a passionate speech about the Sandy Hook shooting. (via People Video),2016-06-18 13:40:00,video,197,34,43,274
86680728811,Walt Disney World installing new warning signs and temporary barriers at resort beaches in wake of alligator attack. http://abcn.ws/1XZRNvW,2016-06-17 16:36:41,photo,195,100,27,322
52150999700,The How I Met Your Mother star is going back behind the camera.,2016-06-21 20:56:00,link,129,7,44,180
13652355666,World markets are already cratering.,2016-06-24 02:00:00,link,2,56,47,105
52150999700,Dustin Lance Black's essay on the Orlando massacre is incredibly moving.,2016-06-21 12:02:06,link,40,53,10,103
25902406772,Should the Pirates consider trading Andrew McCutchen?,2016-06-23 19:12:11,link,91,38,37,166
7245371700,Are you going to send her a card? (via Upworthy),2016-06-18 08:21:06,link,92,80,45,217
10606591490,"""If Rihanna is crying I'm crying you're crying everybody is crying.""",2016-06-22 14:00:07,link,116,92,19,227
10606591490,Satellite images show the glaciers' retreat from 1984 to 2015.,2016-06-16 01:30:08,link,174,67,38,279
5281959998,Another national poll showed Hillary Clinton opening a double-digit lead over Donald J. Trump.,2016-06-15 19:27:56,link,129,61,31,221
18807449704,The Currys can't catch a break.,2016-06-20 22:50:00,link,171,98,20,289
10513336322,"Donald J. Trump will be greeted with far-from-traditional Scottish hospitality, with no senior British or Scottish politicians prepared to meet him and protesters preparing noisy and colourful demonstrations. http://gu.com/p/4mj6g/fb",2016-06-23 19:40:00,link,78,88,1,167
25902406772,LeBron James did what he said he would.,2016-06-20 00:46:49,link,110,23,33,166
75932763901,CONGRATULATIONS!! Chelsea Clinton gives birth to her second child!! Find out the name here (via Closer Magazine) —> http://bit.ly/1V5cu2i,2016-06-19 06:30:00,photo,6,49,38,93
18807449704,"Okay Blake Lively, we have some questions about The Shallows...",2016-06-23 09:19:59,link,150,64,31,245
112638779551,"Good news, Buffalo Bills fans!",2016-06-16 13:26:26,link,52,60,6,118
10606591490,Never second-guess a text again.,2016-06-23 16:30:21,link,43,43,21,107
7245371700,"HBD, Kendrick Lamar!",2016-06-17 15:23:54,link,148,37,41,226
18807449704,Zack Synder's Justice League will be a very different beast from Batman v Superman: Dawn of Justice.,2016-06-21 08:55:12,link,144,11,19,174
5281959998,"When she was first cast in ""Orange Is the New Black,"" she kept her night job.",2016-06-18 21:25:00,link,180,22,47,249
25902406772,Change has come to these NBA squads.,2016-06-22 18:17:11,link,12,11,18,41
18807449704,Basically Game of Thrones,2016-06-20 04:30:00,link,104,70,8,182
25902406772,Mookie is on the up and up.,2016-06-21 14:20:22,link,149,91,16,256
75932763901,"CONGRATS, Ben and Lauren!! Click here for   The Bachelor stars' big news! —> http://bit.ly/28UJETj",2016-06-23 01:00:01,photo,98,56,9,163
112638779551,"This softball player crushes a ball so far it flies into the American Flag! 

Kristen Balboni for @TheBuzzer",2016-06-17 14:09:52,video,40,88,14,142
112638779551,"There's a hilarious reason we're bummed that Webb Simpson didn't make the U.S. Open cut

Kristen Balboni for @TheBuzzer",2016-06-18 18:12:12,video,16,26,12,54
75932763901,SIDE BOOB OVERLOAD! See who narrowly escaped a major nip slip! –> http://bit.ly/28Prpxj,2016-06-23 23:00:00,photo,68,85,41,194
95926963131,Miley Cyrus is proving to be Liam Hemsworth's biggest fan!,2016-06-19 15:00:05,link,85,21,9,115
5281959998,Albania still has an outside chance to move on as a third-place team in UEFA EURO. Here's how.,2016-06-19 01:45:00,link,74,94,19,187
5281959998,"For 16 days, ""The Floating Piers"" will connect two small islands in a lake in Northern Italy to the mainland. http://nyti.ms/23gpEzK",2016-06-17 12:55:00,video,1,42,35,78
95926963131,Chelsea Clinton welcomed her son Aidan—and Hillary Clinton and President Bill Clinton have been swooning! (via People Video),2016-06-19 14:00:00,video,163,21,12,196
25902406772,THE GAME WE HAVE ALL BEEN WAITING FOR.,2016-06-19 09:59:30,link,129,94,6,229
10606591490,The fashion icon is no stranger to wardrobe recycling.,2016-06-23 11:00:04,link,88,93,9,190
95926963131,Hillary Clinton just gifted her Instagram followers with a real '80s gem.,2016-06-19 18:00:32,link,172,26,4,202
52150999700,"You got it, dude–John Stamos is already returning to Fox!",2016-06-16 18:17:39,link,13,5,17,35
86680728811,Erratic winds and triple-digit temperatures are feeding fast-moving fires that are burning across Southern California amid a record heat wave.,2016-06-21 11:24:46,link,83,33,7,123
5281959998,A classic. (via The New York Times Food),2016-06-18 08:55:00,link,42,69,14,125
5281959998,"Breaking News: Jo Cox, a British lawmaker, has died following an attack at a library in her district in northern England, according to the British authorities. A suspect is under arrest.",2016-06-16 09:17:38,link,176,12,4,192
52150999700,The Kanye West/Taylor Swift feud is rearing its head yet again—with some help from Kim Kardashian West.,2016-06-16 11:40:00,link,148,100,9,257
18807449704,Meet your new favorite Game of Thrones character.,2016-06-20 11:00:00,link,93,83,33,209
5281959998,The government may have paid for the flower girls: Two cows named Mona and Lisa.,2016-06-17 13:25:00,link,189,21,10,220
7245371700,It all makes *so* much sense now.,2016-06-21 23:16:50,link,173,76,31,280
13652355666,Marines say they misidentified one man in iconic 1945 Iwo Jima photo.,2016-06-23 17:30:00,video,97,23,48,168
112638779551,Come inside one of the toughest courses on earth with FOX Sports LIVE virtual reality coverage on the NextVR app!,2016-06-17 14:55:43,link,164,54,19,237
5281959998,"""Racial transcendence is a lie, but it's one that O.J. Simpson believed in deeply,"" writes Greg Howard in The New York Times Magazine.",2016-06-18 14:25:00,link,189,76,2,267
5281959998,"Ice cream for breakfast. Yoga on a boat. A strawberry moon. 

We asked you to document the first day of summer. Here's what you saw.",2016-06-22 08:10:00,link,130,65,22,217
52150999700,"Darth Vader is BACK (!!!) in 'Star Wars: #RogueOne'—and we have your exclusive first look at absolutely everything in the newest chapter in a galaxy far, far away: http://share.ew.com/dzNixlK

Photo credit: Lucasfilm",2016-06-22 07:46:52,photo,30,62,45,137
25902406772,New York Giants 1st-round pick Eli Apple has his mom drop him off at practice.,2016-06-23 14:07:32,link,123,78,46,247
52150999700,Wow–Barbra Streisand and Jamie Foxx gave this The Sound Of Music classic a new life. 😱❤️,2016-06-23 08:49:00,link,77,51,31,159
52150999700,Justin Timberlake shut down LeBron James haters with just one tweet. 🏀,2016-06-20 11:34:00,link,162,49,40,251
13652355666,"""Their exposure is phenomenal,"" one trial lawyer in Miami warned.",2016-06-19 13:07:25,link,160,65,43,268
18807449704,KFC wants to solve your phone battery woes.,2016-06-23 09:48:26,link,14,49,14,77
10606591490,He tried to seize a police officer's gun.,2016-06-20 21:00:09,link,115,32,26,173
75932763901,"Shortly after Yolanda H Foster confirmed her departure from The Real Housewives of Beverly Hills, Bella Hadid makes a heartbreaking revelation—> http://bit.ly/1Uyc3lb",2016-06-16 22:30:01,photo,66,21,35,122
5281959998,Donald J. Trump's business interests still drive his schedule.,2016-06-23 04:25:18,link,93,66,39,198
95926963131,These stories will give you an instant mood boost!,2016-06-18 19:40:05,link,126,99,29,254
112638779551,The green jacket winner is trying to keep the pressure off himself at Oakmont for the U.S. Open Championship,2016-06-15 14:12:15,link,129,46,31,206
25902406772,Buddy Hield will be joining the New Orleans Pelicans.,2016-06-23 19:32:57,link,150,89,28,267
5281959998,"The vacation comes just a week after Malia Obama graduated from high school. Malia's looming departure is causing President Obama great emotional turmoil, and during the graduation ceremony he wept behind dark sunglasses.",2016-06-17 21:55:00,link,108,42,37,187
112638779551,"The Boston Celtics drafted Len Bias 30 years ago on June 17. Two days later, his friend Johnny Dawkins of Duke Men's Basketball and a San Antonio Spurs first-round pick in 1986 was stunned by the Maryland Basketball star's death.",2016-06-17 09:59:53,link,195,90,22,307
18807449704,Netflix is debuting a new look.,2016-06-20 15:00:00,link,125,56,4,185
5281959998,"""I came back for a reason,"" LeBron James said. ""I came back to bring a championship to our city.""",2016-06-20 10:55:00,video,141,90,25,256
112638779551,JR Smith stole the show after Game 7 with a heartrending must-see press conference in which he thanked his family for helping him become a champion.,2016-06-20 00:09:28,link,142,16,42,200
112638779551,"Follow Rickie Fowler, Danny Willett and Rory McIlroy all day at the U.S. Open Championship. #USOpenFeatured

WATCH: http://foxs.pt/1UfuDeh",2016-06-18 12:01:21,video,177,87,39,303
95926963131,"Charlie Sheen is facing several lawsuits following his HIV admission, but he claims he did not put any partners at risk.",2016-06-21 10:25:10,link,119,5,9,133
10606591490,Seinfeld fans: Have you tuned in?,2016-06-19 03:30:05,link,170,45,11,226
112638779551,LeBron James trolls the Golden State Warriors with 'Ultimate Warrior' shirt. http://foxs.pt/28JLnPe,2016-06-20 12:32:16,video,38,28,12,78
10606591490,He can hardly contain his excitement.,2016-06-23 03:00:22,link,166,58,14,238
52150999700,Comedy Central's Nikki Glaser went OFF on the Stanford rape case judge.,2016-06-20 15:23:00,link,146,14,41,201
112638779551,"Jason Dufner nearly holed out from 40 yards for birdie, but an unlucky bounce ruined his score",2016-06-16 14:20:41,link,37,29,14,80
5281959998,"This week's ""VEEP"" is a conceptual tour de force — and, more important, it's very, very funny.",2016-06-19 22:25:00,link,113,93,18,224
86680728811,U.S. Coast Guard searching off the coast of Florida for a father and his two teenage sons and daughter after their boat went missing.,2016-06-22 08:32:41,link,6,8,42,56
13652355666,"The reptile that killed a toddler playing near a lagoon at a Disney resort has been euthanized, officials say. http://usat.ly/28SgY12",2016-06-23 13:14:00,video,16,40,34,90
95926963131,Things are heating back up between Kendall Jenner and LA Lakers' Jordan Clarkson.,2016-06-18 14:00:09,link,146,67,1,214
7245371700,Taylor Swift to the rescue.,2016-06-23 17:59:03,link,176,100,47,323
95926963131,Once Rob Kardashian began his whirlwind romance with Blac Chyna his outlook on life changed.,2016-06-22 13:59:08,link,185,30,1,216
5281959998,"College students have come to act as customers — the ones who are always right, the ones who are entitled to satisfaction.",2016-06-22 18:25:00,link,120,92,29,241
25902406772,Was there ever a doubt?,2016-06-19 21:52:40,photo,125,70,21,216
25902406772,"U-S-A *clap* U-S-A *clap*

Our crew will get you up to speed on all things #USMNT, presented by Buffalo Wild Wings.",2016-06-17 16:23:49,video,168,43,22,233
7245371700,He was literally the coolest dad on TV.,2016-06-19 21:59:48,link,155,11,46,212
95926963131,Former Miss Alabama Katherine Webb is documenting her post-baby body on Instagram after delivering her son.,2016-06-20 11:46:03,link,99,70,3,172
52150999700,The Twilight Saga's Taylor Lautner is coming to Scream Queens! 😱 👑,2016-06-23 12:01:58,link,90,44,43,177
75932763901,"CUTENESS OVERLOAD! Find out which star this sleepy little one calls ""mommy"" —> http://bit.ly/28Nrbu5",2016-06-22 06:00:00,photo,12,5,5,22
52150999700,Demi Lovato and Brad Paisley are a surprisingly perfect duo in this sweet video.,2016-06-17 16:44:00,link,146,56,49,251
10513336322,"With #Leave currently more than 1 million votes ahead, and the UK on course to leave the European Union, watch the official referendum result here",2016-06-23 23:36:48,video,156,49,19,224
86680728811,"Donald J. Trump is catering to a different group of voters in light of the Orlando nightclub attack: LGBT voters. ""I'm far better for the gay community"" than Hillary Clinton is.",2016-06-16 20:39:34,link,16,52,24,92
112638779551,"Nihar Janga got the chance to throw up the ""X"" with Dez Bryant while visiting Dallas Cowboys practice.",2016-06-15 13:23:15,link,88,22,28,138
75932763901,HUGE NEWS for the royal family! Get the exciting details (via Closer Weekly) —> http://bit.ly/1WNKuGA,2016-06-15 23:00:00,photo,16,31,39,86
13652355666,"Pixar sequel 'Finding Dory' easily outswam the competition, taking in $136.2 million, according to studio estimates.",2016-06-20 11:10:00,link,157,54,46,257
95926963131,Tyga is finally opening up about his split from Kylie Jenner.,2016-06-17 22:26:50,link,33,67,45,145
25902406772,The Chicago Bulls just made Denzel Valentine's lifelong dream come true.,2016-06-23 20:39:35,video,129,70,33,232
7245371700,Ladylike hilariously calls guys out on the ~ facts ~,2016-06-22 22:51:20,link,152,3,45,200
25902406772,A sale of the UFC could happen sooner than later.,2016-06-16 14:51:57,link,130,96,35,261
112638779551,"Jon ""Bones"" Jones blasts critics who had a problem with his victory at UFC 197 in April.",2016-06-23 12:39:43,link,115,45,29,189
86680728811,British flag flies at half-staff over 10 Downing Street in honor of slain lawmaker Jo Cox. http://abcn.ws/1Unhy4W,2016-06-17 10:15:29,photo,96,2,15,113
75932763901,"LOW BLOW! Scott Disick just attacked Kourtney Kardashian — and when you see how personal he got, you'll understand why she was HUMILIATED! —> http://bit.ly/1YwKXwE",2016-06-17 11:30:01,photo,124,68,41,233
10513336322,"""It took me a while to realise that the wolf knew what he was doing. He was trying to wear me down. He was dogged and determined. I was in trouble.""",2016-06-19 08:00:00,link,4,56,31,91
112638779551,A hardcore UFC loyalist went to his first WWE event and came away with a totally new respect.,2016-06-20 12:59:14,link,19,29,2,50
112638779551,"""Let's face it. I mean, come on man, we saw you trying to run those bases.""",2016-06-20 15:24:56,link,112,89,50,251
18807449704,The fairy tale love of Calvin Harris and Taylor Swift is currently unravelling.,2016-06-15 17:09:55,link,27,37,17,81
18807449704,Yikes.,2016-06-15 01:10:00,link,143,57,31,231
95926963131,There's nothing cuter than our celebrity crushes clocking in some quality baby time. (via People Babies),2016-06-19 06:00:21,link,91,37,42,170
18807449704,Nope. Nope.,2016-06-22 19:31:35,link,6,89,5,100
5281959998,Breaking News: A Supreme Court tie leaves President Barack Obama's plan to shield millions of immigrants from deportation blocked.,2016-06-23 09:52:45,link,73,66,24,163
5281959998,An American man who had been convicted of growing marijuana in Taiwan killed himself in a courtroom.,2016-06-17 07:55:43,link,161,27,44,232
7245371700,"Valid point, Amy Schumer.",2016-06-16 12:03:36,link,110,75,11,196
18807449704,Here's what happens when you ask a scammer for advice on your latest novel. #Scamalot,2016-06-23 13:53:53,video,35,56,29,120
25902406772,Not good news for Detroit Red Wings fans.,2016-06-18 14:09:54,link,85,11,36,132
112638779551,Clay Travis is talking with Derek Dooley live on Outkick The Coverage!,2016-06-16 19:07:17,video,132,39,13,184
18807449704,This person has mastered the fine art of slacking off. 😂 😂,2016-06-22 17:56:39,link,149,71,16,236
52150999700,We can't WAIT for The Big Bang Theory's exciting return!,2016-06-21 13:43:18,link,90,100,14,204
112638779551,The Cleveland Indians have built a spectacular Jobu shrine in their clubhouse.,2016-06-23 09:52:35,link,45,53,9,107
25902406772,You can cut the tension with a knife.,2016-06-15 23:26:37,link,106,90,29,225
10606591490,Feeling hungry?,2016-06-15 02:00:48,link,65,15,42,122
75932763901,Taylor Swift has officially broken her silence after Calvin Harris split! See what she said (via Life & Style Weekly) —> http://bit.ly/1Uh6Avu,2016-06-19 12:45:00,photo,44,1,21,66
18807449704,Nike gave us all the feels.,2016-06-20 10:32:17,link,120,61,33,214
52150999700,Get ready for the return of Empire!,2016-06-16 14:02:02,link,68,84,37,189
5281959998,"For the religious person it's about God. For the terrorist, it's about himself, David Brooks writes in The New York Times Opinion Section.",2016-06-17 20:55:00,link,143,77,4,224
10606591490,"""The glue is even more brittle than before.""",2016-06-24 09:30:26,link,177,53,36,266
5281959998,"Just after sunrise in southern China, staff photographer Josh Haner is flying a drone over the Li River and the dramatic karst landscape of the Guilin National Park.",2016-06-23 19:31:28,video,22,15,18,55
112638779551,"Russell Wilson and the Seattle Seahawks had special visitors at their mini-camp this week.

Nicole Dabeau for @TheBuzzer.",2016-06-15 18:49:52,video,57,1,16,74
7245371700,Selena Gomez and Christina Grimmie's friendship went way back.,2016-06-18 06:00:48,link,149,70,27,246
75932763901,WOW. Kylie Jenner just fired back and sent a major message to Tyga after their split!! (via Life & Style Weekly) —> http://bit.ly/21tRyHb,2016-06-19 13:17:37,photo,42,31,38,111
95926963131,"Bella Hadid shared a sweet moment with her favorite man in the world, her dad.",2016-06-19 17:20:09,link,96,94,19,209
95926963131,"Kelly Osbourne is on good terms with her father Ozzy Osbourne, amid infidelity rumors.",2016-06-18 08:20:07,link,82,82,42,206
112638779551,"""I'm not going to do it!"" 

LeBron James' lips were sealed when asked about his thoughts on the NBA Finals MVP.",2016-06-18 19:24:24,video,51,37,15,103
10513336322,"""You're off!""",2016-06-22 10:20:00,link,153,98,35,286
86680728811,JUMPING FOR JOY: This rescue dog will make your day! Buddy the dog dances with excitement over his automatic fetch toy. http://abcn.ws/1Yv4T2E,2016-06-16 13:38:46,video,110,93,15,218
5281959998,Has terrorism managed to intimidate Americans?,2016-06-15 08:55:00,link,14,17,34,65
52150999700,We don't blame you if you thought The Walking Dead's Andrew Lincoln was really American. 😱,2016-06-18 05:39:00,link,80,23,47,150
10513336322,"Surrounded by colleagues, John Lewis told the House: ""We have been too quiet for too long. There comes a time when you have to say something. You have to make a little noise. You have to move your feet. This is the time.""",2016-06-22 17:30:00,link,49,18,38,105
10513336322,"After a 16-hour search, the body of a two-year-old boy has been found after he was dragged into the water by an alligator at Walt Disney World resorts yesterday as his father tried to save him.",2016-06-15 18:32:03,link,158,72,24,254
5281959998,"""The newest T-shirt in town is 'Believeland, Ohio.'"" Read on in The New York Times Opinion Section.",2016-06-20 11:10:00,link,49,3,43,95
112638779551,"Desperate times call for desperate measures...

Cavaliers fan launches GoFundMe campaign to bribe Kevin Love to sit out Game 6

http://www.foxsports.com/nba/story/cavaliers-fan-launches-crowdfunding-campaign-to-pay-for-kevin-love-to-sit-out-game-6-061516",2016-06-15 17:28:15,link,33,58,5,96
75932763901,"EVERYONE is freaking out about these photos of Kate Middleton — and when you see the rest of the pics, you'll know why! (via Closer Weekly) —> http://bit.ly/28HANxy",2016-06-16 23:00:00,photo,173,68,34,275
25902406772,LeBron James is getting the last laugh now.,2016-06-20 21:38:30,link,102,73,34,209
75932763901,LOL! This A-list celebrity couple just face swapped on Snapchat — can you tell who they are? (via Closer Weekly) —> http://bit.ly/1UOsjdA,2016-06-22 01:00:00,photo,158,92,30,280
112638779551,"Turns out, Stephen Curry hit the son of a minority owner of the Cleveland Cavaliers.",2016-06-17 02:25:03,link,148,78,17,243
52150999700,"In honor of #FathersDay, we're celebrating the men who provide the worst jokes, but all the wisdom. 💭",2016-06-19 10:37:00,link,16,78,19,113
10513336322,"""When you go to a restaurant, you want the charm, the service, the conviviality. It's about personalities. It's not surprising delivery companies are doing well, as there is demand, but I'll eat my hat if deliveries outstrip restaurants.""",2016-06-17 11:40:00,link,110,79,40,229
10606591490,"""How do I deal with a coworker who is overly attached to me?""",2016-06-16 02:00:12,link,6,84,3,93
112638779551,It's a one man show and may make you a bit uncomfortable.,2016-06-20 14:27:15,link,181,1,49,231
10513336322,"""Once you've determined whether you really are a perfectionist, you may wish to consider whether this is a good thing. If you're a socially prescribed or other-oriented perfectionist – that is, if your standards are either dictated by others or you impose them on others – then I can tell you straight away that it's not.""",2016-06-22 06:20:00,link,62,60,23,145
75932763901,THIS MEANS WAR! Taylor Swift's latest comments about Kim Kardashian West and Kanye West TOTALLY crossed the line! Find out what she said —> http://bit.ly/1ttJF9z,2016-06-16 20:30:00,photo,89,20,9,118
86680728811,"Alligator attacks 58-year-old man about an hour from where boy was killed by a gator outside Disney resort, authorities in Florida say.",2016-06-21 20:57:52,link,16,23,50,89
112638779551,Not a misprint.,2016-06-18 23:11:19,photo,120,6,29,155
112638779551,"LeBron James has a new buddy, the Lawrence O'Brien Trophy given to the NBA champion Cleveland Cavaliers and he isn't parting with it.",2016-06-23 21:36:09,link,138,55,10,203
5281959998,"""Learning that he was in fact personally rejected will be upsetting to him. On the other hand, it might help him adjust for such situations in the future.""",2016-06-15 08:25:00,link,61,59,13,133
52150999700,This story makes 'Finding Dory' even more delightful!,2016-06-17 11:58:18,link,133,81,46,260
112638779551,"So, how many Atlanta Braves relievers does it take to open a bullpen door?",2016-06-18 05:29:33,link,125,80,35,240
13652355666,BREAKING: Campaign manager Corey Lewandowski has left Donald J. Trump's organization.,2016-06-20 09:00:42,link,177,43,50,270
5281959998,Daily Briefing: Here's what you need to know today.,2016-06-21 05:30:01,link,66,72,4,142
25902406772,The Cleveland Cavaliers will be celebrating their NBA Championship.,2016-06-22 09:07:34,link,194,60,16,270
86680728811,Ticketmaster customers who received vouchers and coupon codes stemming from class-action lawsuit now know how they can use them: The company has released a preliminary list of 406 eligible events.,2016-06-21 19:26:32,link,3,6,9,18
112638779551,"Bubba Watson has a creative (and illegal) way of tackling the rough at the U.S. Open Championship this week!

Andy Nesbitt for @TheBuzzer",2016-06-15 14:18:31,video,62,78,29,169
5281959998,Mashed potatoes have another gear.,2016-06-23 06:25:01,link,74,8,5,87
10606591490,Just one more reason to see Finding Dory.,2016-06-21 00:30:07,link,173,68,20,261
112638779551,"Is Kevin Durant on the move? LeBron James has gotta stay, right? See what's in store for all the biggest NBA free agents.",2016-06-22 06:40:26,link,108,19,5,132
95926963131,Johnny Depp's friend Doug Stanhope is speaking out about being sued by Amber Heard for defamation.,2016-06-20 22:28:12,link,62,63,2,127
95926963131,Taylor Swift and Tom Hiddleston's budding romance continues to be the talk of the town.,2016-06-22 07:44:03,link,68,67,41,176
52150999700,This Kim Jong-il story is the strangest love story cinema may ever know.,2016-06-19 03:34:00,link,173,37,42,252
95926963131,"Bristol Palin is sending her new husband one very big, very sweet ""thank you.""",2016-06-19 14:41:31,link,87,44,10,141
95926963131,Hilary Duff is missing her son—and sending a positive message to working moms. (via People Babies),2016-06-18 13:00:04,link,45,71,11,127
75932763901,HYPOCRITE?! The story of Taylor Swift's breakup with Calvin Harris is sounding very familiar —>  http://bit.ly/28ODs8S,2016-06-19 10:00:00,photo,61,46,29,136
13652355666,So cute.,2016-06-19 01:50:00,link,5,1,37,43
10606591490,"""It was not just a hobby, it was an act of survival.""",2016-06-19 02:00:29,link,87,86,15,188
10606591490,"The Brexit vote ""is a victory for Trumpism the world over.""",2016-06-24 06:32:22,link,138,56,17,211
25902406772,Who wouldn't want this bus?!,2016-06-15 08:27:02,link,63,43,37,143
10606591490,Always wished you could perform a duet with Whitney Houston or Tupac?,2016-06-24 00:00:16,link,141,94,33,268
75932763901,CONGRATS!!! We are over-the-moon for Blake Shelton and Gwen Stefani —> http://bit.ly/25NZTMd,2016-06-16 09:34:14,photo,62,26,32,120
5281959998,"Of his fellow Bernie Sanders backers throwing their support to Hillary Clinton? ""Disgusting,"" said John Flaherty, a retired photographer from Massachusetts.",2016-06-19 10:25:00,link,139,28,24,191
13652355666,This wasn't Johnson's first go-around with a ruling.,2016-06-19 19:24:01,link,183,13,22,218
25902406772,Emotions are running high between U.S. Soccer and Ecuador.,2016-06-16 22:20:04,link,84,62,41,187
52150999700,Don't mess with these movies. 🐴  🎬,2016-06-23 02:31:00,link,104,52,7,163
95926963131,The best video you'll watch all day. (via PEOPLE Pets),2016-06-18 18:40:06,link,111,35,17,163
86680728811,Data show gun owners are more likely to have higher incomes—and to vote http://abcn.ws/1Y2Gpzp,2016-06-19 17:44:13,link,152,78,9,239
10513336322,"""It has taken 22 years for this simple idea to grow to its present scale: we are eight days from a vote that could make it real. The leave campaign has focused to a depressing extent upon immigration. But the case for departure has deeper intellectual roots that cannot be dismissed as mere nostalgia, xenophobia or reactionary reflex. The idea of Brexit has become part of the warp and weft of politics. The question unexplored is: how?""",2016-06-15 06:20:00,link,76,87,34,197
18807449704,"""Are we living in the dark ages?""",2016-06-17 07:53:54,link,68,58,42,168
52150999700,The Fosters season premiere was easily—and unfortunately—its most timely.,2016-06-20 22:51:09,link,155,11,38,204
52150999700,Christian Bale's Batman has shaped over a decade of superhero origin stories.,2016-06-15 23:10:00,link,172,86,7,265
95926963131,Tonight's The Bachelorette was full of Chad drama—but it's not the Chad you're thinking of. 😱,2016-06-20 21:20:05,link,192,88,11,291
25902406772,Noah Syndergaard was pulled early due to an elbow injury.,2016-06-22 16:10:20,link,7,100,27,134
13652355666,"""On the Democrats' side, we have a known known. On the Republican side, we have a recent entry, who's a known unknown.""",2016-06-23 10:30:00,link,147,26,6,179
52150999700,The film was an INSTANT sensation with audiences back in 1962.,2016-06-22 21:24:00,link,86,3,41,130
75932763901,"'Teen Mom' star Farrah Abraham claimed she was promoting a product in this pic – when you see the full photo, you'll understand why fans are FURIOUS –> http://bit.ly/1Yu9BxV",2016-06-23 22:00:00,photo,14,78,39,131
25902406772,"Nothing like barbershop talk to get to know someone. 

And Anthony Davis' new teammate is no exception.",2016-06-23 19:30:15,video,84,99,14,197
112638779551,"Dana White promises Joanne Calderwood won't be ""broke as hell"" for much longer.",2016-06-22 11:45:28,link,105,68,22,195
10606591490,Powerful.,2016-06-15 21:30:24,link,49,4,17,70
7245371700,"Reminiscing on my angsty teen years while listening to Thirty Seconds to Mars' ""The Kill.""",2016-06-18 19:03:05,link,183,6,11,200
52150999700,John Cena cuddling with puppies will make your day. 😍 🔥,2016-06-15 16:49:00,link,90,54,31,175
86680728811,U.S. company announces the first clinical trial of a Zika vaccine intended to prevent the virus from spreading further.,2016-06-21 18:15:47,link,27,88,28,143
13652355666,💔,2016-06-23 02:30:00,link,199,22,17,238
52150999700,Team Arrow is getting bigger in season 5! 👊🏼,2016-06-15 14:54:41,link,141,31,18,190
86680728811,Wife of fallen South Carolina officer killed in the line-of-duty takes her maternity photos with help from the police department he belonged to.,2016-06-21 16:09:29,link,140,63,36,239
75932763901,"Remember the ""hot felon"" Jeremy Meeks?! He's back in the spotlight — and you have to see how he looks post-prison! —> http://bit.ly/28EV1rV",2016-06-15 14:00:01,photo,170,77,13,260
25902406772,The Boston Celtics and Milwaukee Bucks might have a huge trade in the works.,2016-06-23 15:39:02,link,92,40,23,155
52150999700,The Conjuring fans are about to get spooked—again. 😱  👻,2016-06-15 20:07:00,link,181,82,30,293
5281959998,Will your team make the Round of 16 as a third-place team in UEFA EURO 2016? Group play is almost over and we're here to help you make sense of it all.,2016-06-22 10:45:26,link,198,56,50,304
5281959998,Suggesting that Donald J. Trump and the Republicans would best serve the LGBT community is absurd on many levels. Read on in The New York Times Opinion Section.,2016-06-20 06:55:00,link,122,33,24,179
13652355666,We remember the 49.,2016-06-15 17:56:00,video,185,88,3,276
25902406772,The Toronto Raptors get a big man with the 9th pick.,2016-06-23 19:48:09,link,147,78,5,230
18807449704,REALLY?!,2016-06-17 04:28:00,link,91,92,50,233
7245371700,Of course there are no female writers on Adult Swim + Elizabeth Banks couldn't play Mary Jane in Spider-Man  because ageism + sexism in Hollywood rules everything.,2016-06-23 11:15:24,link,168,48,44,260
7245371700,This massacre has left us angry and afraid. Here's what you can do to help.,2016-06-15 07:14:47,link,196,22,5,223
7245371700,Where you'll play as Donda West.,2016-06-18 07:20:00,link,50,86,26,162
5281959998,"A screen version of ""WICKED The Musical"" has finally been scheduled for release by Universal Pictures.",2016-06-16 21:10:00,link,48,78,31,157
95926963131,Ironically Donald J. Trump has frequently compared himself to Ronald Reagan since launching his campaign.,2016-06-22 16:33:03,link,39,50,50,139
13652355666,She's 9 years old.,2016-06-16 00:40:00,link,138,98,25,261
95926963131,The model was recalled in April due to a defect in the car's transmission.,2016-06-20 12:30:05,link,194,91,41,326
86680728811,"'Strawberry moon' lights up the sky, syncing with the summer solstice for the first time in decades.",2016-06-21 09:26:16,link,44,4,22,70
112638779551,"Colin Cowherd is happy for Cleveland and LeBron James, but NOT Cavs owner Dan Gilbert.",2016-06-20 15:03:38,video,143,36,17,196
52150999700,"Get well soon, Uma Thurman!",2016-06-23 10:23:00,link,96,22,26,144
52150999700,"Strap on your proton packs! The new Ghostbusters cast dishes on special cameos and that sexist backlash: http://share.ew.com/Q0nOoDB 👻

Photo Credit: Justin Stephens for EW",2016-06-16 11:15:07,photo,47,87,16,150
10513336322,"Gareth Bale: ""Wales play for the shirt and dragon.""",2016-06-16 04:10:00,link,14,25,42,81
52150999700,Now you can taste The Walking Dead: Literally. 🍴  🍔,2016-06-18 21:29:00,link,145,82,27,254
25902406772,LeBron James outshined the league's MVP on the NBA's biggest stage.,2016-06-20 10:05:48,photo,63,72,11,146
95926963131,Time to rewrite the frog Kama Sutra. (via PEOPLE Pets),2016-06-18 05:00:46,link,38,15,39,92
5281959998,The annual Yulin Lychee and Dog Meat Festival draws condemnation from animal rights supporters. But its supporters say the food pairing is all about energy and balance.,2016-06-21 04:25:00,link,115,28,5,148
7245371700,"We're only halfway through 2016, but shows like Broad City + The People v. O.J. Simpson: American Crime Story are dominating the TV world.",2016-06-18 22:00:47,link,130,78,9,217
10606591490,Amazing.,2016-06-20 03:30:09,link,71,87,16,174
5281959998,"""The whole doping scandal is a painful blow for the Kremlin, and humiliation for Russia.""",2016-06-18 00:55:00,link,86,61,29,176
18807449704,The story of this Dave Grohl/ Taylor Swift/ Paul McCartney collaboration is priceless. 😂,2016-06-23 15:30:00,link,42,64,3,109
86680728811,"Saudi Arabia's relationship with the U.S. will only ""grow stronger and deeper in all areas, irrespective of who is in the White House,"" the Saudi foreign minister said. http://abcn.ws/1QchV3M",2016-06-17 19:57:28,link,196,34,22,252
5281959998,"""There is no appetite to be nice on the day after.""",2016-06-20 02:55:00,link,107,23,6,136
13652355666,"There's ""no question"" the little boy taken by an alligator is dead, the sheriff says. http://usat.ly/1UUQA1Q (AP photo)",2016-06-15 11:36:31,photo,30,88,19,137
112638779551,The New York Giants would like their players to be safe this summer.,2016-06-17 13:03:39,link,159,73,49,281
112638779551,"""So you're telling me there's a chance...""",2016-06-15 08:09:55,link,123,83,49,255
5281959998,You'll sometimes run from your guests.,2016-06-21 08:55:00,link,185,1,10,196
52150999700,"Aw–Selena Gomez's sweet fan knows EVERY lyric, and their dance party is amazing. ❤️",2016-06-23 09:06:00,link,101,63,46,210
7245371700,"Here's what you 'Need to Know' on 6/22 from Demi Lovato, Blake Lively, and Tyler the Creator.",2016-06-22 05:26:40,video,176,17,16,209
18807449704,#1: Get birth control.,2016-06-18 09:35:21,link,166,35,1,202
25902406772,Indianapolis Colts QB  Andrew Luck makes ZERO excuses.,2016-06-23 15:30:03,link,70,49,7,126
95926963131,"To the rest of the world Christopher Reeve was Superman, but to his son Will, he was just dad.",2016-06-16 12:09:03,link,59,17,8,84
75932763901,"OMG! Blake Lively just made an unexpected revelation amid rumors she's pregnant with baby No. 2 — and we seriously wonder how her husband, Ryan Reynolds feels after hearing THIS (via Life & Style Weekly): http://bit.ly/28KhWNh",2016-06-21 04:45:00,photo,91,6,23,120
18807449704,Your frequent-flyer miles may be more valuable than you think.,2016-06-23 20:47:03,link,135,5,24,164
7245371700,Better get started on my video.,2016-06-17 13:57:09,link,160,11,27,198
52150999700,This is a major 🔑  to success.,2016-06-15 19:21:00,link,82,68,27,177
25902406772,The Toronto Maple Leafs have a brand new goalie.,2016-06-20 17:33:50,link,72,16,17,105
52150999700,Tom Hanks has seriously turned up the intensity in the newest Dan Brown adaptation. 🔥🔥🔥,2016-06-23 17:57:00,link,130,90,25,245
25902406772,Dave Gettleman may not be in good standing with agents after these comments.,2016-06-20 14:50:29,link,195,24,40,259
10513336322,"""I've seen so much more love in this community in these past few days than the gunman's hatred. I've seen people coming together to display the good part of humanity and the soul of my city, and that is the answer.""",2016-06-18 12:40:00,link,29,62,32,123
10513336322,"""The polls say the vote hangs in the balance. But I refuse to believe it. I don't believe Britain will take leave of its senses and plunge down into the dark and rancid place the Brexiters would drag us. I want our country back – and I expect it to step back from the brink of this midsummer madness.""",2016-06-21 03:00:00,link,195,69,48,312
7245371700,Remember this is Game of Thrones we're talking about...,2016-06-20 11:06:04,link,23,10,43,76
75932763901,Giuliana and Bill Rancic's son isn't so little anymore! Wait until you see how big Duke has gotten in this new photo (via Closer Weekly) —> http://bit.ly/1TZO4Kk,2016-06-19 01:30:00,photo,129,4,23,156
112638779551,"From The Pittsburgh Steelers to the Miami Dolphins, every team's run game ranked.",2016-06-23 09:20:18,link,176,57,45,278
13652355666,We ❤️ dads.,2016-06-17 13:21:00,link,152,99,36,287
112638779551,"As the city of Pittsburgh welcomes the 2016 U.S. Open Championship, we look back at some of the other legendary sports icons of a proud city.

Remembering Roberto Clemente, in the words of Pittsburgh Pirates star Andrew McCutchen.",2016-06-16 08:14:14,video,194,5,38,237
10606591490,"""She thought that by being polite and using her manners, the search would be quicker.""",2016-06-16 17:00:25,link,164,85,4,253
7245371700,It's a load of barnacles.,2016-06-23 23:24:29,link,21,1,37,59
18807449704,"Slaughterhouses are expected to kill some 10,000 dogs during the event.",2016-06-22 05:06:48,link,21,63,34,118
95926963131,"A few years ago, Chris Van Etten never would have imagined having this job.",2016-06-18 21:30:11,link,43,37,13,93
7245371700,Time to start sleeping with the lights on.,2016-06-22 04:57:25,link,171,1,15,187
112638779551,Ángel Cabrera made one of the best shots of the tournament thus far at No. 9.,2016-06-17 12:20:15,link,36,20,34,90
52150999700,That Game of Thrones scene was BRUTAL—and deserved. 👊🏼 🐶,2016-06-20 12:41:23,link,91,22,13,126
13652355666,"""Right now Orlando is running on adrenaline, anger, bravado and compassion. But those body blows, they take a toll especially when you think you're all right.""",2016-06-15 17:27:00,link,93,30,46,169
7245371700,Take your pick for Animation Fandom of the Year: http://on.mtv.com/28Q53RK,2016-06-22 15:30:00,photo,16,31,21,68
13652355666,Hillary Clinton's day just got better.,2016-06-23 15:00:00,link,126,32,32,190
75932763901,She's GLOWING!,2016-06-22 21:00:01,link,185,57,17,259
7245371700,Kibbles n' Boltons is all the rage in Westeros.,2016-06-23 00:36:33,link,107,14,33,154
25902406772,Muhammad Ali's grandson has some serious talent.,2016-06-15 12:02:03,link,95,85,19,199
52150999700,The Bachelorette's resident bad boy just broke his silence.,2016-06-21 07:55:00,link,43,25,49,117
95926963131,More details emerge about the Orlando gunman's wife.,2016-06-17 13:58:07,link,77,50,2,129
95926963131,Authorities have shifted their efforts from search and rescue to search and recovery less than a day after the little boy was attacked.,2016-06-15 12:28:02,link,15,14,21,50
10606591490,"No, it's not paranoia.",2016-06-24 09:00:33,link,101,82,22,205
25902406772,Construction on U.S. Bank Stadium wrapped up earlier this month.,2016-06-22 13:30:32,link,105,72,48,225
52150999700,The secret's out! Forest Whitaker's character looks EXTREME in '#RogueOne: A Star Wars Story.' 👊🏼,2016-06-22 13:16:32,link,39,4,1,44
112638779551,The upside to having your name misspelled on your Super Bowl ring? Now you have two of them.,2016-06-16 19:34:25,link,102,70,5,177
112638779551,"LeBron James led the Cleveland Cavaliers to the franchise's first title, but it looks like James might not be adding to his gold-medal haul.",2016-06-20 14:59:32,link,51,94,18,163
18807449704,1. Respect their feelings.,2016-06-22 01:00:00,link,58,20,5,83
10513336322,"""Let the record show: calm, reasonable, friendly Americans also believe in gun rights.""",2016-06-22 08:40:01,link,41,68,11,120
10513336322,The latest news and updates on the EU referendum as Britain goes to the polls.,2016-06-23 07:40:08,link,130,29,21,180
75932763901,"Just six months after announcing their engagement, SAD news for Mariah Carey and her billionaire fiancé James Packer (via Life & Style Weekly) —> http://bit.ly/1roCez3",2016-06-16 02:15:00,photo,23,51,38,112
10513336322,"""Part and parcel of surviving cancer is knowing, and loving, far too many people who won't be as lucky.""",2016-06-23 12:40:00,link,11,86,35,132
75932763901,CONGRATS!!!! The Duggar clan is about to get a little BIGGER! Get the scoop on the new addition —> http://bit.ly/28JxeMR,2016-06-20 16:30:01,photo,108,33,44,185
7245371700,So basically every one of my favorite artists is on this album.,2016-06-17 13:19:56,link,55,15,4,74
18807449704,GoBone: All-day play for your dog while you're away.,2016-06-16 11:30:00,video,5,31,3,39
10606591490,1. Say their name…a lot.,2016-06-19 05:00:25,link,114,72,23,209
75932763901,"""I think when you say no, down the line it will be a better decision."" She's one of the sexiest women in Hollywood – but did you know this 27-year-old bombshell is still a VIRGIN! –> http://bit.ly/1U8JS7P",2016-06-24 23:00:01,photo,28,57,5,90
10606591490,Its origin is surprising.,2016-06-19 14:30:12,link,126,55,10,191
13652355666,"Happy Father's Day! Patrick Foster and Jim Lenahan, hosts of USA TODAY's Dad Rock podcast, discuss gifts for dad that are inspired by the great outdoors. http://usat.ly/28F0Gy3",2016-06-19 14:05:00,video,99,28,43,170
112638779551,Police confirm three men have been arrested in conjunction with an alleged assault on #NASCAR driver Mike Wallace and his daughter Lindsey.,2016-06-20 10:43:35,link,116,59,1,176
25902406772,Michael Phelps will be aiming to add to his Olympic-record medal total.,2016-06-22 14:23:53,link,186,76,1,263
75932763901,"He's been out of the spotlight since the early 2000's, but it's his recent Instagram posts that are getting the attention now! –> http://bit.ly/1TLoypj",2016-06-19 15:15:00,photo,148,61,2,211
7245371700,Things might seriously be heating up on Game of Thrones...,2016-06-19 10:19:07,link,63,82,11,156
86680728811,"On top of fleeing violence and instability, tens of thousands of refugee children ""risk detention, rape, forced labour, beatings or death,"" while journeying to Europe, UNICEF report finds.",2016-06-15 02:34:00,link,164,91,5,260
95926963131,As if running a marathon wasn't hard enough!,2016-06-22 09:34:06,link,65,81,6,152
86680728811,The National Weather Service reports the temperature about that time was 94 degrees but felt like 102 degrees at nearby Bush Intercontinental Airport. http://abcn.ws/1USJjCu,2016-06-17 11:17:40,link,198,46,33,277
112638779551,What's faster: A golf ball or a #LexusRCF? Lexus Greatest Drive Challenge.,2016-06-19 12:06:34,video,85,53,26,164
5281959998,Jeannette McCoy tells her story on how she survived the shooting in Orlando.,2016-06-15 18:55:00,video,123,80,23,226
86680728811,Chicago middle school graduate gets 'yuge' laughs for his graduation speech after combining his love of politics and impressions: http://abcn.ws/1Xqh6X0,2016-06-15 19:35:13,video,13,94,13,120
75932763901,We are SO happy for Teen Mom 2 star Jeremy Calvert — but we wonder how Leah Messer will react to this shocker: http://bit.ly/28ZJwn3,2016-06-23 21:30:00,photo,31,97,43,171
10513336322,The Conjuring sequel tells the story of mysterious paranormal activity at a north London home 40 years ago. What exactly went on in that cramped terraced house? It began when a bed began to shake …,2016-06-16 13:00:00,link,28,63,47,138
112638779551,Russell Wilson took Ciara on a helicopter ride over the Seattle Seahawks' stadium,2016-06-18 11:19:56,link,81,24,17,122
5281959998,The children had asked if it was safe to take a boat trip at a time when storms were forecast with winds up to 45 miles per hour.,2016-06-20 14:55:00,link,147,63,35,245
7245371700,"Considering what happened on The Challenge last night, let's talk about this.",2016-06-23 08:16:08,link,39,94,5,138
10513336322,Dump Trump?,2016-06-20 01:40:00,link,90,3,22,115
18807449704,Genius. 👏 👏,2016-06-22 23:31:06,link,28,22,23,73
13652355666,The longest day of the year is upon us. http://usat.ly/28IETyV,2016-06-20 17:34:00,video,130,77,14,221
10513336322,"The British astronaut Tim Peake has landed back on Earth after six months in space, touching down in Kazakhstan at the end of a seven-hour return journey from the International Space Station.",2016-06-18 04:40:00,link,117,79,39,235
86680728811,"Donald J. Trump on Hillary Clinton's campaign slogan. ""Her campaign slogan is 'I'm with her.' You know what my response is to that, 'I'm with you, the American people.'"" http://abcn.ws/28TRgWs",2016-06-22 09:58:27,video,159,80,31,270
7245371700,What do old pizza and last night's episode of Game of Thrones?,2016-06-20 19:15:04,link,107,72,45,224
25902406772,Dray says the Golden State Warriors would be hoisting the trophy right now if he wasn't suspended.,2016-06-15 14:27:18,link,188,56,18,262
112638779551,"Good pick or nah, LA Lakers fans?",2016-06-24 00:45:39,link,144,36,47,227
95926963131,Soleil Moonfrye talks about her four kids' different personalities and how fulfilled she feels now that her family is complete. (via People Babies),2016-06-22 06:00:45,link,70,35,50,155
7245371700,"""He no doubt had a huge impact on upcoming rappers who watched him run rampant like a lunatic with a microphone."" (via DJBooth)",2016-06-18 12:09:05,link,165,13,43,221
25902406772,Italy and Sweden are set to face off.,2016-06-17 08:13:58,link,150,86,45,281
75932763901,Awful.,2016-06-21 21:30:00,link,54,28,23,105
75932763901,CONGRATS! Find out who welcomed a baby girl —> http://bit.ly/1ZRi90k,2016-06-19 13:45:00,photo,67,75,22,164
112638779551,Seattle Mariners icon Ken Griffey Jr. got to rub elbows with Barack Obama on Thursday.,2016-06-23 22:52:42,link,144,55,25,224
7245371700,"""What happened in Orlando, a scene of murder and mayhem, was terrorism, in that it was intended to make us feel terror, and to make LGBTQ people aware that being ourselves with one another is dangerous and to be avoided. 

But it won't work.""",2016-06-19 07:35:40,link,46,28,8,82
25902406772,The Florida Gators Football Mt Rushmore is in. Did they get it right?,2016-06-16 14:19:11,link,143,27,4,174
5281959998,"Creative thinking is stymied by stray thoughts, obsessive ruminations and other forms of ""mental load."" (via The New York Times Opinion Section)",2016-06-17 19:55:00,link,53,15,31,99
112638779551,Gregory Bourdy has plenty to love about Oakmont Country Club after a second round 67 at the U.S. Open Championship. #USOpen,2016-06-18 12:14:21,video,79,62,35,176
10513336322,"""To the viewer paying half-attention, as entertainment, the leavers won the night. The hope of the remainers must be that the voters may nonetheless wake up in the night, and distil their dull list of nagging questions into Davidson's pithy peroration: Why take the risk?""",2016-06-22 01:20:07,link,196,29,12,237
5281959998,"In 2000, detectives reportedly screamed at him, banged on the table and told him he would be going to prison for the rest of his life. Finally, the eighth-grade student confessed.

In 2014, new DNA tests helped lead to his release after 13 years in prison. Now he's suing the police and the city of Denver.",2016-06-21 10:55:00,link,142,6,47,195
25902406772,Sounds like the King will get some well-deserved rest this summer.,2016-06-20 12:25:54,link,142,91,44,277
7245371700,Broadway's best owned the red carpet spotlight.,2016-06-18 02:07:53,link,44,51,29,124
13652355666,"""Some of the refrigerants now in use by Trader Joe's are up to 4,700 times more potent than carbon dioxide.""",2016-06-21 20:55:00,link,30,1,19,50
25902406772,The Cleveland Cavaliers gave their fans something to celebrate.,2016-06-20 09:19:21,link,82,46,15,143
75932763901,Andi is NOT going to be pleased when she sees this...,2016-06-15 11:00:00,link,13,26,33,72
5281959998,There are 2 basic options for cases left on the docket this term if the justices are deadlocked at 4 to 4.,2016-06-23 12:55:00,link,106,76,32,214
25902406772,Let's check in with the GOAT...,2016-06-19 21:45:09,video,33,44,22,99
18807449704,The passion and fire of Steve Jobs is the gift that keeps on giving.,2016-06-21 23:10:00,link,145,38,40,223
52150999700,It's wonderful to see late-night king Jay Leno back where he belongs!,2016-06-16 09:52:00,link,3,15,4,22
25902406772,What would Stephen Curry be like in a different era?,2016-06-17 21:27:57,link,153,10,46,209
75932763901,HYPOCRITE?! The story of Taylor Swift's breakup with Calvin Harris is sounding very familiar —> http://bit.ly/28ODs8S,2016-06-19 22:00:00,photo,152,10,3,165
5281959998,"While you're watching Wales on the field during UEFA EURO, see in real time its chances of advancing to the next round.",2016-06-20 01:25:00,link,63,54,49,166
10606591490,"""They gave us to them.""",2016-06-15 05:30:11,link,128,35,28,191
75932763901,RIP — our thoughts are with Caitlyn Jenner during this difficult time: http://bit.ly/28Oaugx,2016-06-23 19:30:00,photo,4,93,43,140
75932763901,This is what Kim Kardashian West looks like now — but when you see what she looked like 10 years ago you'll understand why fans have accused her of getting MAJOR plastic surgery! See the pics —> http://bit.ly/1sIdoLW,2016-06-16 14:14:21,photo,68,81,4,153
52150999700,This moving tribute to Christina Grimmie will bring you to tears. ❤️,2016-06-18 13:29:59,link,44,95,8,147
13652355666,"""I am a flawed human being who makes mistakes and am filled with shame over this incident.""",2016-06-22 03:00:01,link,86,15,3,104
112638779551,Steph Curry won't reveal what LeBron said after huge block,2016-06-17 09:04:34,link,93,54,35,182
112638779551,The Los Angeles Dodgers and Boston Red Sox are among the teams making good use of a system that leaves other clubs behind.,2016-06-21 19:19:25,link,14,27,45,86
52150999700,"Rest in peace, Alejandro Fuentes.",2016-06-19 15:47:00,link,147,5,29,181
75932763901,OMG! We could NOT recognize this famous lady after such a drastic transformation — you will NEVER believe who she is: http://bit.ly/28LDf0b,2016-06-22 06:45:00,photo,88,84,8,180
7245371700,Selena Gomez is strutting her stuff.,2016-06-23 19:15:55,link,147,2,17,166
25902406772,Some members of the 1995-96 Chicago Bulls are making their thoughts on the Warriors known.,2016-06-20 22:06:00,link,127,31,39,197
10606591490,"""The reboot deserves better.""",2016-06-24 01:30:13,link,54,93,3,150
5281959998,Britons will make a momentous choice today that could matter more for their future than any ordinary election: whether to leave or stay in the European Union.,2016-06-23 07:25:00,link,176,34,5,215
112638779551,Pete Rose has plenty of respect for Ichiro Suzuki.,2016-06-18 01:27:21,link,177,80,13,270
112638779551,Baltimore Ravens quarterback Joe Flacco is making strides in his ACL recovery but doesn't feel like himself yet.,2016-06-21 20:31:00,link,161,52,32,245
5281959998,"A Canadian man held captive by the militant group Abu Sayyaf has been decapitated, Philippine officials said.",2016-06-15 00:25:00,link,109,66,32,207
10606591490,Is it a good idea to hit the gym after happy hour?,2016-06-15 09:30:34,link,95,3,6,104
86680728811,"How hot is it in Arizona? Hot enough to bake cookies on your car's dashboard, apparently. http://abcn.ws/28K0Fzf",2016-06-21 02:34:04,photo,55,8,35,98
112638779551,Will history repeat itself Thursday night in Game 6?,2016-06-16 11:23:56,link,107,88,47,242
10513336322,"Nadiya Hussein: ""Porridge reminds me of Dad being in hospital. He needed a blood transfusion and was possibly high on morphine, because he'd rave on about how he really loved that porridge in hospital, then refused to believe anyone could make porridge as well as the nurse, who I think he secretly fancied.""",2016-06-19 07:20:00,link,129,85,28,242
25902406772,The New York Rangers and The Florida Panthers have made a deal.,2016-06-20 20:01:37,link,142,89,40,271
7245371700,Maybe we should be learning something from the '90s...?,2016-06-23 15:13:12,video,134,67,43,244
86680728811,Aerial footage shows massive wildfire burning in Southern California. http://abcn.ws/28IWsg8,2016-06-20 16:59:25,video,10,32,44,86
112638779551,LeBron James championship mural to come down for Rebublican National Convention,2016-06-22 00:02:14,link,71,57,5,133
10513336322,"""It was so hot and humid and I was having trouble sleeping, and then I remembered how cool the chimp's bed in Tanzania had been.""",2016-06-21 12:20:00,link,1,95,23,119
112638779551,MLB on FOX insider Ken Rosenthal has the latest from around MLB,2016-06-18 22:03:03,link,174,76,40,290
112638779551,LeBron James sent a message with this hellacious dunk in Game 7.,2016-06-19 20:04:52,link,200,75,33,308
25902406772,"Big Papi regrets announcing his retirement so early, but not because he's coming back for another year.",2016-06-20 21:09:04,link,144,43,38,225
13652355666,Lin-Manuel Miranda is hanging up his riding boots (for now).,2016-06-16 10:48:00,link,181,22,1,204
52150999700,Joni Mitchell's 'Blue' is undoubtedly one of the greatest albums of all time. 💙,2016-06-22 21:01:00,link,146,2,29,177
86680728811,"Jaguar used in Olympic torch relay ceremony shot to death after escaping leash and trying to attack a soldier, Brazilian army says.",2016-06-22 01:45:05,link,52,63,39,154
13652355666,Watch this demolition: The Las Vegas Strip will never be the same. http://usat.ly/1tuiDzn,2016-06-16 02:49:00,video,183,34,20,237
5281959998,"""A ddylai'r Deyrnas Unedig ddal i fod yn aelod o'r Undeb Ewropeaidd?""",2016-06-23 15:25:00,link,133,45,21,199
7245371700,I'm loving this side of Demi Lovato.,2016-06-17 11:56:55,link,18,87,46,151
7245371700,I can't keep up with Kylie Jenner's hairstyles anymore.,2016-06-16 12:32:32,link,166,36,14,216
13652355666,"The sun-powered Solar Impulse aircraft lands in Europe, after completing one of the most challenging trips of the more than year-long journey around the world. (Getty Images)

More things to know today: http://usat.ly/28RUjSF",2016-06-23 06:27:08,photo,8,72,8,88
18807449704,Elon Musk says the Tesla Model S 'floats well enough' to double as a boat.,2016-06-21 21:00:00,video,62,30,7,99
10513336322,"""Shake it very well until it's ice-cold, then add a large chunk of onion"" – is this how James Bond orders his martini in the books?",2016-06-23 09:20:00,link,86,1,26,113
18807449704,The women claimed they had chanced upon 'a new beauty hack',2016-06-20 04:00:00,link,124,77,23,224
13652355666,"Florida alligators may bite, but they usually don't kill.",2016-06-15 08:30:00,link,85,93,19,197
75932763901,Nia Vardalos has changed SO much since 'My Big Fat Greek Wedding'! Wait until you see how different she looks 14 years later (via Closer Weekly) —> http://bit.ly/28NJvmH,2016-06-22 00:00:00,photo,54,96,13,163
25902406772,The Brooklyn Nets and Indiana Pacers have made a move.,2016-06-23 13:21:32,link,110,86,26,222
5281959998,"SIREN: WASHINGTON TO LOSE ITS DAILY BARD AT A MOST UNCERTAIN TIME: MIKE ALLEN WILL STOP WRITING POLITICO'S MORNING PLAYBOOK COLUMN MIDCAMPAIGN, on July 11",2016-06-20 04:55:00,link,132,16,8,156
13652355666,Roll out.,2016-06-18 11:15:00,photo,92,22,9,123
112638779551,Indiana Pacers star Paul George has an adorable new friend named Kobe,2016-06-15 10:09:53,link,157,78,35,270
75932763901,PREGNANT! Find out who is expecting her third baby in three years (via Closer Weekly) —> http://bit.ly/1SdwzF7,2016-06-15 03:00:00,photo,179,53,35,267
112638779551,It's one of the true spectacles in golf. Dustin Johnson CRUSHES a drive to start his second round. Enjoy. #LexusRCF #USOpen,2016-06-17 14:47:30,video,174,15,24,213
112638779551,This is why you shouldn't try to dunk over people.,2016-06-23 12:02:18,link,57,16,19,92
86680728811,"Colorado groom bit by a rattlesnake while taking wedding photos. ""I admire Laura and Johnny so much for staying calm, and holding each other's hand through the first great test of their brand-new marriage.""",2016-06-22 16:10:54,link,135,19,11,165
18807449704,Led Zeppelin Official's 'Stairway to Heaven' still stands.,2016-06-23 17:21:20,link,5,6,40,51
7245371700,Did someone say Idris Elba?!,2016-06-23 13:08:59,link,111,2,39,152
13652355666,"""I don't want there to be any doubt that my heart and Gesa's heart intensely longs for you every day.""",2016-06-15 09:07:25,link,126,100,38,264
25902406772,Los Angeles Rams fans are hyped.,2016-06-19 13:34:02,link,94,11,14,119
112638779551,Fans heard the pup and sprung into action.,2016-06-20 09:56:23,link,77,23,10,110
5281959998,Go ahead. You've earned it.,2016-06-18 11:55:00,link,155,41,40,236
95926963131,Taylor Swift and Tom Hiddleston were spotted dancing and cuddling at Selena Gomez's concert in Nashville!,2016-06-22 07:00:03,link,112,34,3,149
25902406772,Time to jump on the Baltimore Orioles bandwagon.,2016-06-18 11:16:02,link,91,73,8,172
13652355666,Happy Father's Day! Let's give dads their due.,2016-06-19 07:35:00,video,39,62,20,121
112638779551,The New York Knicks reportedly have interest in a trade for the Chicago Bulls' Derrick Rose,2016-06-18 07:09:37,link,83,89,9,181
7245371700,"Another Period returns to Comedy Central tonight for another season of buffoonish caricatures, including Harriet Tubman.",2016-06-15 18:43:03,link,3,14,33,50
52150999700,"Sarah Jessica Parker is bringing sex and romance (or lack thereof) back to HBO, Sex and the City fans!",2016-06-22 13:58:35,link,116,68,7,191
86680728811,FBI – Federal Bureau of Investigation asks for the public's assistance with any information regarding the alleged Orlando shooter. http://abcn.ws/1trduHR,2016-06-15 13:21:54,photo,113,27,39,179
86680728811,"North Carolina couple welcomes identical triplets in a rare, one-in-a-million occurrence.",2016-06-20 13:01:21,link,117,44,25,186
10606591490,"Chelsea Handler: ""I don't have a lot of guilt, no. I've always been this way. I'm missing a chip.""",2016-06-16 11:30:05,link,120,66,38,224
25902406772,The Philadelphia Eagles have pretty much everything but a title.,2016-06-21 12:43:02,link,28,80,14,122
112638779551,Mocking Stephen Curry before a must-win game for the Cleveland Cavaliers is not the best idea.,2016-06-16 10:06:12,link,44,7,20,71
112638779551,The challenging Oakmont course got the best of at least one golfer at the U.S. Open Championship.,2016-06-17 20:49:31,link,108,29,25,162
112638779551,Top-seeded Roger Federer is upset in the semifinals of Gerry Weber Open.,2016-06-18 08:45:57,link,25,73,46,144
95926963131,Read The Bachelorette contestant's fiery response.,2016-06-23 10:14:06,link,115,95,11,221
10606591490,Feeling stuck?,2016-06-18 01:30:08,link,130,37,3,170
7245371700,I have yet to see a concert better than number 2.,2016-06-20 01:05:39,link,119,34,20,173
18807449704,"Many of these photographs have rarely been seen in Vietnam, let alone in the rest of the world.",2016-06-18 19:00:00,link,7,40,14,61
75932763901,Find out how far along she is!,2016-06-16 16:30:00,link,75,47,35,157
86680728811,Fans attending the Copa América Centenario 2016 soccer game at Soldier Field take shelter in stadium concourse as severe weather moves through the Chicago area. http://abcn.ws/28P6ETy,2016-06-22 20:50:04,video,146,40,12,198
13652355666,"More ""foul"" trouble.",2016-06-17 13:01:00,link,78,40,31,149
7245371700,Prince lives on through his music.,2016-06-20 22:13:27,link,152,17,33,202
7245371700,"Oh, so that's how Demi Lovato gets flawless skin.",2016-06-16 20:41:08,link,153,30,47,230
7245371700,It's her first GQ cover.,2016-06-17 04:42:33,link,7,27,42,76
7245371700,Let's listen to LGBTQ people from Orlando and beyond tell their stories in our special podcast episode.,2016-06-17 22:00:53,link,149,98,44,291
13652355666,"Andrew Zimmern, host of Travel Channel's Bizarre Foods, is always looking beyond what's (sometimes moving) on the plate.",2016-06-21 19:30:00,link,31,80,17,128
95926963131,The mom was horrified when she realized the viral video she was watching was of her own child.,2016-06-17 16:32:05,link,67,12,15,94
112638779551,Talk U.S. Open with Kristen Balboni!,2016-06-18 16:44:04,video,125,49,39,213
25902406772,The statement from the conference is a follow-up to a request made to Baylor by Big 12 Board.,2016-06-22 13:35:42,link,23,49,43,115
112638779551,The Carolina Panthers got roasted by the Denver Broncos after trying to comfort the Golden State Warriors.,2016-06-20 10:19:47,link,106,55,14,175
10606591490,From Amy Schumer to Barack Obama.,2016-06-24 02:00:50,link,55,91,27,173
86680728811,"""When we were in the bathroom, the guy, the shooter just started saying, 'Everybody come out! Everybody's going to die,'"" survivor Miguel Leiva said. http://abcn.ws/1Ubb7j3",2016-06-16 11:25:08,link,93,39,6,138
7245371700,What's up with political correctness? And how are we really using it?,2016-06-22 13:30:10,link,64,3,44,111
18807449704,See also: poor life choices.,2016-06-22 14:00:00,link,29,100,17,146
5281959998,"""Radical Islam"" explained: What the phrase means, and why some leaders refuse to say it.",2016-06-17 02:25:00,link,28,66,38,132
10606591490,"""The only way to defeat ISIS is to retake lost territory.""",2016-06-22 12:00:38,link,11,98,1,110
112638779551,"This kid has some pretty epic frisbee trick shots

Kristen Balboni for @TheBuzzer",2016-06-18 18:56:56,video,19,74,24,117
86680728811,Group overseeing emoji standards removes the rifle from an upcoming emoji update after Apple voices concern.,2016-06-21 01:08:41,link,142,92,30,264
13652355666,"That's where the public shaming — aka the ""Mommy Wars"" — ignites on social media, where many facelessly and anonymously place blame.",2016-06-17 01:05:00,link,131,7,45,183
18807449704,Adam Levine was Christina Grimmie's coach and mentor on The Voice.,2016-06-15 13:58:38,link,18,17,36,71
112638779551,"Thanks, LeBron!",2016-06-22 07:49:30,link,121,50,49,220
86680728811,"House Democrats, chanting ""No bill, no break,"" say they plan to stay on the floor until they get a vote on proposals to strengthen background checks and block individuals on the terror watch list and no-fly list from buying guns. http://abcn.ws/28SZaSo",2016-06-22 21:04:25,video,134,55,16,205
10513336322,"As the price of digital radios continues to drop, which one best suits your listening habits?",2016-06-19 13:00:00,link,135,8,35,178
95926963131,"Tyga opens up about his son with Blac Chyna, King Cairo, being a mini version of himself. (via People Video)",2016-06-19 21:00:00,video,36,28,12,76
18807449704,Not sure if this is what Airbnb had in mind...,2016-06-17 13:37:07,link,133,22,4,159
25902406772,These new Sacramento Kings uniforms are fresh.,2016-06-15 12:44:30,link,175,83,46,304
7245371700,That's a very strong statement for Adam to make.,2016-06-21 06:53:36,link,185,18,2,205
112638779551,"JJ Watt officially unveiled the ""JJ I"" on Thursday.",2016-06-23 12:30:04,link,55,51,4,110
112638779551,It's the dawn of a new era for Cleveland sports.,2016-06-21 10:08:22,link,13,54,37,104
25902406772,This would be interesting...,2016-06-19 13:38:01,link,144,73,21,238
86680728811,Former Vanderbilt University football player Brandon Vandenburg was found guilty in the rape of an unconscious woman in his dorm room and is expected to face a minimum of 15 years in prison.,2016-06-20 17:34:19,link,166,45,46,257
112638779551,"From the driving range to the 18th green, Lexus has you covered. Tune in LIVE to the FOX Sports broadcast using the NextVR app now!",2016-06-17 18:41:11,link,99,74,25,198
52150999700,"The biggest Game of Thrones villain can't wait for the EPIC ""Battle of the Bastards."" 😱",2016-06-19 18:31:00,link,90,13,50,153
25902406772,Have the Cavs broken a Cleveland curse that spans more than half a century?,2016-06-20 09:51:27,link,9,79,39,127
25902406772,"Thanks for making us all feel like failures, kid.",2016-06-15 14:24:54,link,95,23,16,134
5281959998,"""The fact is, what we have here isn't a gator problem, it's a people problem."" (via The New York Times Opinion Section)",2016-06-15 21:25:00,link,58,16,42,116
75932763901,Remember when Demi Lovato's little sister Madison De La Garza starred on 'Desperate Housewives'? Wait until you see how stunning she looks today (via Closer Weekly) —> http://bit.ly/1RLVKw2,2016-06-19 08:30:00,photo,112,47,33,192
25902406772,The Warriors offense was unstoppable all season long... and then it stopped cold at the worst time possible.,2016-06-19 23:50:05,photo,50,72,22,144
10606591490,Here's how to stay on top of your duties.,2016-06-19 10:00:41,link,124,32,1,157
18807449704,Wonderful. 😊 😊,2016-06-19 09:00:01,link,121,50,18,189
112638779551,"PSA: Remember, Sunday is #FathersDay.",2016-06-17 09:42:07,link,20,90,24,134
10513336322,"""Decision-makers do not even rely on scientists to measure the effectiveness of different management strategies, whether it's putting elephants on birth control, culling macaques, or locking up leopards and other species for life. Unless that haphazard management style changes, people and wildlife may ultimately cease to exist together outside protected areas — especially as India displaces China to become the most populous nation in the world by 2030.""",2016-06-22 11:41:01,link,183,43,34,260
75932763901,WTF?! Did she mean to expose her nipples to a whole group of photographers?! Find out who –> http://bit.ly/28o5NCK,2016-06-17 09:06:04,photo,38,57,13,108
13652355666,Here's why C-SPAN has to use Facebook Live footage to show you the House Democrats' sit-in.,2016-06-22 15:15:00,link,12,94,31,137
86680728811,"Luis Omar Ocasio-Capo, 20, and Eric Ortiz-Rivera, 36, are the first two victims of the mass shooting to be laid to rest Thursday afternoon in Orlando. http://abcn.ws/1OsXDCq",2016-06-16 15:24:44,link,142,31,25,198
10513336322,"""Aaron Ramsey hears talk that he's set to become the new Frank Lampard.""",2016-06-23 06:10:01,link,169,13,43,225
95926963131,There's a lot you may not know about the youngest son of Christopher Reeve.,2016-06-18 18:20:02,link,13,65,17,95
13652355666,A weekend of funerals for many of those killed in last Sunday's massacre at an Orlando gay nightclub resulted in more casualties Saturday when two sheriff's deputies on motorcycles accompanying a procession to a burial site were struck and severely injured by an impatient driver.,2016-06-19 00:05:05,link,117,68,27,212
10513336322,"""A one-man media hurricane dominating the news with insults and provocations, promises and policy pronouncements. He could be funny and coarse and buffoonish and broke all the rules about presidential conduct.

This may sound familiar as Donald J. Trump marches towards the Republican presidential nomination. But actually it describes Venezuela from 1999 to 2013 under the reign of Hugo Chávez.""",2016-06-22 10:40:00,link,153,80,9,242
5281959998,Melissa Clark and The New York Times Food show you how to make a delicious meal in 30 minutes — including dessert.,2016-06-17 12:15:04,video,192,22,49,263
7245371700,"And her baby pic is adorable, too.",2016-06-20 23:29:54,link,119,7,27,153
10606591490,"From Drake's ""One Dance"" to Justin Timberlake's ""Can't Stop The Feeling.""",2016-06-21 01:00:17,link,191,29,36,256
18807449704,Using the toilet is so passé.,2016-06-18 13:31:37,link,92,85,20,197
13652355666,"""If people want to stare at you, then they can stare at both of us.""",2016-06-22 15:48:00,link,11,14,8,33
52150999700,RuPaul's Drag Race is back! Meet the stunning all stars of the summer: http://share.ew.com/mnKwr3M,2016-06-17 14:36:00,video,133,73,34,240
86680728811,"President Barack Obama and Senator Marco Rubio step off Air Force One in Orlando, greeted by Florida Gov. Rick Scottt and Orlando Mayor Buddy Dyer. http://abcn.ws/23e5mqH",2016-06-16 12:00:27,video,41,10,16,67
10513336322,We're dying to know.,2016-06-16 08:00:00,link,21,47,16,84
52150999700,Ghostbusters should've actually called Carly Rae Jepsen for the new theme song. 🎶👻,2016-06-23 13:56:00,link,184,58,27,269
13652355666,"As Yosemite Falls roared in the background, President Obama spoke to a crowd Saturday on the values of national parks, conservation and preservation.",2016-06-19 03:05:05,link,109,22,6,137
86680728811,"The debate on whether Britain should leave the European Union—a move dubbed the ""Brexit""—took a bizarre turn today as the two camps staged a flotilla face-off on the river Thames near Big Ben in London. http://abcn.ws/28EIJjd",2016-06-15 13:00:00,link,89,4,10,103
25902406772,Dave Chappelle has been in the GYM.,2016-06-20 13:35:43,link,145,18,27,190
25902406772,The IOC upholds the track and field ban and adds stipulations for other athletes.,2016-06-22 09:47:32,link,152,22,35,209
5281959998,"Prince William's decision to allow himself to be photographed for a gay magazine, one expert said, shows a royal ""pushing the envelope further than we've seen before.""",2016-06-15 17:55:00,link,75,11,12,98
86680728811,A jury has convicted a former Vanderbilt football player of encouraging his teammates to rape an unconscious woman he had been dating. It took jurors just over four hours of deliberation Saturday before finding Brandon Vandenburg guilty on several counts.,2016-06-19 00:36:30,link,14,99,6,119
7245371700,Rep. John Lewis is currently leading a sit-in for gun control legislation — but it's not his first time.,2016-06-22 17:01:58,link,22,11,36,69
112638779551,"What. A. Weekend.

Curtis Strange joins Shane Bacon on The Clubhouse Podcast to recap the 2016 U.S. Open Championship at Oakmont.",2016-06-20 19:48:18,link,103,76,18,197
52150999700,WOW–Finding Dory is already breaking huge records! 👏💸🐠,2016-06-17 13:25:00,link,132,61,41,234
5281959998,Afghan interpreters risked their lives for American troops. Now Congress is preparing to abandon them. Read on in The New York Times Opinion Section.,2016-06-23 05:25:00,link,134,32,43,209
7245371700,"Laugh all you want, but this documentary seems to have a lot of terrifying twists and turns...",2016-06-21 02:02:23,link,147,93,5,245
25902406772,The Oklahoma City Thunder don't need Serge Ibaka.,2016-06-23 14:57:32,link,182,46,10,238
52150999700,The Vampire Diaries and The Originals just scooped up these Containment stars! 🙌🏻,2016-06-23 14:46:01,link,194,86,17,297
7245371700,Taking a stab at rounding up everything that happened in the deadliest Game of Thrones episode to date.,2016-06-22 07:11:52,link,194,34,37,265
95926963131,"It's time to meet the man behind Ina Garten's newest cookbook, Cooking For Jeffrey! (via People Food)",2016-06-23 10:57:59,link,13,87,37,137
86680728811,"SOLDIER SURPRISE: U.S. Army soldier, deployed since October, surprises his children at a Virginia elementary school. http://abcn.ws/1XZWqG9",2016-06-17 17:32:04,video,69,51,16,136
95926963131,Blake Lively and Ryan Reynolds' home will soon look like The Brady Bunch! (via People Babies),2016-06-20 18:02:06,link,77,17,29,123
95926963131,Justin Theroux is Jennifer Aniston's loving husband—and shopping buddy!,2016-06-19 11:00:32,link,75,9,6,90
86680728811,"First openly gay Army Secretary honors Orlando victims and heroes at pride event. ""As horrific as this attack was, it wasn't an attack on Orlando, it wasn't an attack on the LGBT community, it was an attack on America.""",2016-06-21 17:53:06,link,95,65,23,183
5281959998,Meet America's loneliest Donald J. Trump supporter.,2016-06-17 04:54:46,link,121,58,27,206
10606591490,"""People, journalists, publishers will have different opinions about whether they would have published the eight seconds of grainy sex that was the illustration of the article.""",2016-06-22 11:00:10,link,144,88,47,279
75932763901,RIP! Our hearts are with this actor's loved ones during this difficult times —> http://bit.ly/1PzDIg3,2016-06-18 18:45:00,photo,12,21,2,35
95926963131,People's List cohosts Jerry O'Connell and SuChin Pak are taking YOUR questions!,2016-06-16 18:07:13,video,32,37,28,97
10513336322,"""If Eric Dier stands out it is perhaps because he is the only player in England's starting front six unquestionably in his right position, and undeniably the best man available for the job. Everyone else is to some degree a squeeze, a fudge, a gambit. Whereas Dier is something else, a convert to the midfield shield role who really does have the air of a specialist these days, an improving, intelligent 22-year-old who is in his own way the first of this type England have produced since the idea of a four-square 4-4-2 bit the dust.""",2016-06-17 10:10:01,link,12,29,26,67
25902406772,Martinez will miss 4-6 weeks due to an elbow injury and will need a replacement.,2016-06-17 10:00:58,link,46,34,28,108
52150999700,Pretty Little Liars' Lucy Hale has come a long way since she was on The O.C.,2016-06-19 01:15:00,link,137,32,32,201
10513336322,"The Sun's article made no mention of the fact that Shannen Doherty had breast cancer, which the star had revealed last August. She has since spoken publicly about coping with the illness.",2016-06-23 11:20:00,link,92,53,19,164
86680728811,Oh deer! Deputies hope this wayward fawn is able to reunite with its mother after being rescued from a Colorado bathtub.,2016-06-16 01:50:05,link,14,86,33,133
25902406772,UH OH! Bill Walton may be a legend at Street Fighter too.,2016-06-16 14:49:13,link,163,64,44,271
112638779551,"There's no way LeBron James leaves the Cleveland Cavaliers again, right?",2016-06-21 12:48:11,link,143,51,17,211
10606591490,See you on the other side.,2016-06-22 21:30:07,link,94,36,11,141
10513336322,Are you the type of person who makes friends easily? Find out with something called the wall-sit test.,2016-06-19 11:00:00,link,76,69,22,167
75932763901,TOO SMALL? She's about ready to bust out of her tiny sequined bikini! 😳 See who —> http://bit.ly/1VXuOzz,2016-06-18 18:15:00,photo,179,1,33,213
18807449704,Is this what Game of Thrones has been building up to?,2016-06-16 13:12:13,link,29,59,8,96
52150999700,We're chatting live with Fitz & the Tantrums! 🙌🏻,2016-06-20 16:09:03,video,146,62,10,218
5281959998,"""There were some kids in my class that were different. Sometimes I wasn't kind to them. I didn't know it at the time, but I know now that they were gay. I will forever regret not treating them with the kindness, dignity and respect — the love — that they deserved. For that, I sincerely and humbly apologize.""",2016-06-16 17:55:00,link,25,51,25,101
112638779551,"English golfer Andrew ""Beef"" Johnston discovering the American meat will make you hungry. Mmmmm. Beef. #PROcast",2016-06-18 11:17:33,video,124,61,18,203
10513336322,"""There had been a lot of talk in the build-up about the need to show passion and heart. All a chimera, of course: the way to win at sport is to play cold, to seize in a state of transcendent calm whatever glimpse of space is offered. Daniel Sturridge did exactly that.""",2016-06-17 05:00:00,link,8,84,13,105
95926963131,Famous or not—these celebs' PDA are giving us all the feels. 💕,2016-06-24 04:00:50,link,12,22,39,73
112638779551,"The Golden State Warriors may have set an NBA record with 73 wins in the regular season.

But on Thursday night, Klay Thompson admitted their season would be a failure, if they lose Game 7 to the Cleveland Cavaliers....",2016-06-17 11:02:32,link,177,16,39,232
25902406772,A play that will live forever.,2016-06-19 22:58:33,photo,181,9,19,209
112638779551,"Dustin Johnson holds a 1 shot lead at the @U.S. U.S. Open Championship and has been notified that he may be assessed a 1 stroke penalty following the completion of his round. 

USGA's Managing Director Jeff Hall explains the situation.",2016-06-19 17:49:49,video,36,70,25,131
112638779551,The Cleveland Cavaliers' championship was celebrated on Twitter.,2016-06-19 22:50:39,link,70,17,9,96
95926963131,The man was never charged with any crime related to the girl's death. (via People True Crime),2016-06-23 19:26:53,link,14,70,22,106
112638779551,"""I have nothing to lose."" U.S. Open Championship surprise Andrew Landry talks with Shane Bacon ahead of his final round starting time. #USOpen",2016-06-19 13:30:15,video,177,86,16,279
10606591490,This might be the reason you can't get over your ex.,2016-06-16 02:30:15,link,64,21,11,96
112638779551,"With famed Dallas Cowboys practice facility 'Valley Ranch' closing today, many players are reflecting on their time with the team. 

That included coach Jason Garrett, telling an incredible story about playing with wide receiver Michael Irvin....",2016-06-16 12:30:08,link,195,79,36,310
75932763901,"""[We engage] in all different kinds of sex... We're animals!"" — Find out which hunky star made this steamy sex confession! (via Life & Style Weekly) —> http://bit.ly/28QjVLF",2016-06-24 04:45:00,photo,15,27,14,56
10513336322,"The decision in favour of Brexit, following a bitterly close electoral race, represents the biggest shock to the political establishment in Britain and across Europe for decades, and will threaten the leaderships of both the prime minister, David Cameron, and the Labour leader, Jeremy Corbyn.",2016-06-23 22:59:12,link,2,46,24,72
7245371700,Things are getting steamy between these two.,2016-06-23 14:29:47,link,19,53,20,92
13652355666,"Meanwhile, a Hamilton mix tape is being readied for release in October.",2016-06-17 03:05:01,link,117,47,30,194
75932763901,FINALLY! It's the Miley Cyrus and Liam Hemsworth news we've ALL been waiting for —> http://bit.ly/28J6tb3,2016-06-20 10:01:01,photo,55,36,12,103
13652355666,"She was on a church trip in Charlotte, N.C.",2016-06-22 20:20:00,link,183,85,38,306
86680728811,"Requests for abortion pills have increased significantly in 7 Latin American countries after Zika-related health warnings were issued there, study finds.",2016-06-23 00:55:07,link,11,88,49,148
112638779551,"Despite missing the cut at the U.S. Open Championship, Rickie Fowler keeps things in perspective.",2016-06-18 13:18:23,video,1,63,43,107
10513336322,"""Parents should avoid commenting on their children's weight or appearance: that includes criticism, teasing, or even 'positive' statements.""",2016-06-20 04:20:00,link,159,55,24,238
25902406772,"Thibs got his man.

The Minnesota Timberwolves watched Kris Dunn fall right into their laps.",2016-06-23 19:07:26,photo,114,55,35,204
10606591490,"A former FBI deputy director says the investigative guidelines are too ""restrictive.""",2016-06-15 09:00:24,link,166,37,27,230
10606591490,This is not a drill.,2016-06-21 20:01:06,link,28,17,27,72
95926963131,Detectives in Louisiana now believe they know what happened to the 3-year-old siblings who tragically died in a pickup truck.,2016-06-22 18:23:06,link,145,43,7,195
13652355666,Curry has thrived amid the scrutiny and the expectations to become a household name.,2016-06-19 04:50:00,link,50,60,23,133
25902406772,"Those are just the breaks sometimes, Rookie.",2016-06-23 19:53:32,link,102,61,50,213
52150999700,This is HUGE news about the Kick-Ass series! 🙌🏻,2016-06-22 13:39:00,link,31,30,7,68
10606591490,But Jenna Dewan Tatum understands why fans lust after her husband.,2016-06-22 14:30:34,link,160,36,3,199
10513336322,"""I hang up, tears stinging my eyes. A boy looks up nervously. I wish I had better news for him but I have to tell him that social services will not respond to our plea for help. This means another night on a bench in the park, and he is already thin, dirty and getting ill with exhaustion. His friend, another asylum seeker, killed himself a week ago, and our fear is that he will do the same.""",2016-06-20 04:00:00,link,108,51,25,184
10606591490,"""This outfit is a fraud—it is a deception.""",2016-06-21 23:00:36,link,29,90,19,138
95926963131,More than 15 gators have been removed from Walt Disney World property in 2016 alone.,2016-06-23 13:10:05,link,146,24,26,196
10513336322,"""My book – and my life – is not a work of fiction.""",2016-06-15 08:20:00,link,17,86,5,108
52150999700,Grease is the word!,2016-06-16 14:40:00,link,160,14,1,175
10606591490,Could you be more forgiving?,2016-06-16 20:00:10,link,162,78,29,269
10513336322,"""You're scared to get out of that life because you can't see anything better beyond it. You need safety, counselling – and protection from people who might kill you because you're worth hundreds of thousands of dollars to them.""",2016-06-21 12:00:00,link,122,51,11,184
7245371700,"""Christina was so sweet and full of love.""",2016-06-18 05:32:56,link,115,65,25,205
10606591490,"Officials are ""confident"" they captured the alligator that attacked 2-year-old Lane Graves",2016-06-22 17:30:16,link,181,17,33,231
112638779551,Jimmy Butler thought beating Jaylen Brown 1-on-1 would be easy....No. 3 overall Brown had another idea. #NBADraft,2016-06-23 19:47:48,video,27,100,50,177
95926963131,The controversy surrounding Brooks' cancer diagnosis couldn't be avoided on tonight's return of Real Housewives of Orange County.,2016-06-21 00:00:08,link,110,56,9,175
7245371700,Come hang out with us in Wonderland.,2016-06-15 15:47:25,photo,81,40,19,140
10513336322,"Another senseless act of mass murder has sadly sparked the same chain reaction. A community has gone into mourning, fear once again stalks the land. Politicians have called for a moment's silence while refusing to do anything to stop the next one. And gun companies have emerged as the only winners.",2016-06-16 12:00:00,link,5,64,29,98
75932763901,"Heartbreaking. Just days after going public with her relationship, Bethenny Frankel is opening up about her miscarriage —> http://bit.ly/28NubCM",2016-06-22 17:00:01,photo,198,32,24,254
7245371700,I have yet to see a concert better than number 2.,2016-06-16 17:39:24,link,10,73,11,94
25902406772,The Colorado Rockies and Miami Marlins had quite an interesting night.,2016-06-21 10:59:02,link,176,33,44,253
18807449704,"""When he honked the horn of his city dump truck at me and blew kisses, I was head over heels."" #nowomanever",2016-06-20 08:07:03,link,42,83,25,150
75932763901,This couple just recently just recently called it quits – but he is desperate to hang on to her! Hear what he said –> http://bit.ly/1Q90bWM,2016-06-18 21:15:00,photo,119,90,12,221
25902406772,The U.S. Open Championship is off to a slow start.,2016-06-16 17:05:37,link,143,68,47,258
52150999700,Finding Nemo's Dory will always be our favorite forgetful blue fish. ❤️,2016-06-18 11:16:00,link,103,8,29,140
18807449704,UGH,2016-06-23 04:32:32,link,186,37,3,226
75932763901,Adrienne Bailon SPEAKS OUT about Rob Kardashian and Blac Chyna's relationship – and she says the last thing anyone was expecting –> http://bit.ly/24WnzIy,2016-06-19 14:45:00,photo,147,9,2,158
18807449704,😂 😂 😂,2016-06-15 05:34:57,link,170,56,6,232
52150999700,Donald J. Trump insults Late Night with Seth Meyers in response to ban: http://share.ew.com/LTVxx0q,2016-06-16 23:55:00,video,193,83,34,310
112638779551,The New York Knicks hope they aren't done with their summer shopping.,2016-06-23 13:28:03,link,108,64,29,201
7245371700,A very familiar name has Miley Cyrus' back - and heart. <3,2016-06-22 01:57:11,link,36,9,39,84
13652355666,BREAKING: Supreme Court blocks President Obama's effort to protect more than 4 million undocumented immigrants.,2016-06-23 09:54:07,link,22,87,26,135
5281959998,"Ching-Ching Ni is at Beijing's famous Panjiayuan Antique Market. Join her as she searches for hidden treasures among the more than 4,000 shops at the market.",2016-06-18 20:22:13,video,189,9,1,199
25902406772,There just weren't a ton of bright spots against Argentina.,2016-06-21 23:34:03,link,42,79,48,169
95926963131,Molly Ringwald looks back on her teenage years in a recent interview with Lenny Letter,2016-06-17 17:38:08,link,151,37,25,213
95926963131,Calvin Harris is back to business—with Rihanna.,2016-06-16 01:01:46,link,38,28,3,69
10606591490,Watch live from London as Nigel Farage speaks about the Brexit at a Leave EU party,2016-06-23 17:36:08,video,26,65,31,122
5281959998,"""When you present politics as a matter of life and death, as a question of national survival, don't be surprised if someone takes you at your word.""",2016-06-18 06:55:00,link,38,28,1,67
25902406772,The numbers don't lie...,2016-06-19 22:02:54,photo,180,66,43,289
10513336322,"""The neighbouring countries to Syria that have taken in the refugees are under tremendous strain. Their economies and infrastructure are nowhere near as developed as ours. We cannot walk away from this catastrophe.""",2016-06-21 13:20:00,link,123,46,15,184
10606591490,It's the latest on the secret menu.,2016-06-24 05:00:34,link,91,34,39,164
10513336322,Donald J. Trump's presidential run was a protest candidacy. But when the monster rose from the laboratory table and walked no one was more surprised than the Donald himself.,2016-06-22 09:00:00,video,16,39,24,79
52150999700,These celebrity #FathersDay tributes are perfect. 😍,2016-06-19 12:47:00,link,17,93,39,149
95926963131,Apparently this dog doubles as a dentist! 😱 (via PEOPLE Pets),2016-06-20 01:00:11,link,67,49,32,148
10513336322,"""We tried to guess each other's age and he thought I was two years older.""",2016-06-18 08:20:00,link,139,76,42,257
25902406772,The Curry family wasn't scared to support and defend Stephen Curry.,2016-06-17 13:37:33,link,40,85,6,131
112638779551,"""You can't C(ease and Desist) me!""",2016-06-19 16:18:30,link,38,68,11,117
52150999700,This The Beatles documentary will give fans an all-access look into the band's rise to fame. 🌟  🎶,2016-06-20 19:04:00,link,7,84,33,124
25902406772,LeBron James is simply the king.,2016-06-16 22:42:24,photo,158,35,39,232
86680728811,The O.J. Simpson white Ford Bronco slow-speed police chase happened on this day 22 years ago.,2016-06-17 09:26:17,photo,52,22,23,97
7245371700,"The late singer's daughter Paris has urged everyone to ""ignore the trash.""",2016-06-22 12:57:47,link,133,76,3,212
7245371700,Calvin Harris's summer 2016 music takeover is in full-effect.,2016-06-24 08:50:33,link,66,55,37,158
10606591490,"Sex and the City fans, you'll want to hear this.",2016-06-20 22:30:12,link,131,34,8,173
18807449704,This gift from Donald J. Trump was priceless. 😂,2016-06-18 10:00:00,link,128,47,14,189
25902406772,The Colorado Rockies experiment with Jose Reyes didn't go as planned.,2016-06-23 14:10:35,link,90,13,43,146
5281959998,"""The Supreme Court will soon decide whether other women will have to go through what I did,"" Valerie Peterson writes in The New York Times Opinion Section.",2016-06-15 23:55:00,link,66,26,13,105
10606591490,The 27-year-old was killed in a fatal traffic collision.,2016-06-20 02:30:16,link,169,87,5,261
7245371700,John got pretty emotional...,2016-06-22 10:05:08,link,70,24,10,104
112638779551,"U.S. Soccer vs Argentina. Tuesday. 7PM ET on FS1.

Plan accordingly.",2016-06-18 20:01:54,photo,6,16,25,47
10606591490,Does he still believe Daenerys is the best ruler for the seven kingdoms?,2016-06-16 15:30:03,link,108,62,15,185
10513336322,"From our archive, our writers drew on the best available expertise to assess what Brexit might mean for growth, jobs, trade, immigration and Britain's position in the world.",2016-06-23 22:00:00,link,1,31,33,65
7245371700,He also had some very beautiful things to say about his late baby sister.,2016-06-19 05:47:08,link,145,9,37,191
10513336322,"""Whatever happens on 23 June, a reckoning lies ahead. We are plunging into the depths of the national psyche in search of answers, and the consequences will be with us for decades. Whether we decide to stay or dare to go, be in no doubt that this is, most assuredly, only the beginning.""",2016-06-20 06:20:00,link,80,46,49,175
18807449704,Can we talk about Chrissy Teigen's Instagram game.,2016-06-20 14:30:00,link,193,21,1,215
112638779551,"Assembling the most volatile, temperamental team imaginable.",2016-06-21 09:03:00,link,42,28,12,82
5281959998,Today's Supreme Court defeat will force President Barack Obama to finish his term without securing the major progress he promised to millions of Latino immigrants living under the threat of deportation.,2016-06-23 11:25:00,link,141,38,43,222
13652355666,"""Michael didn't live in peace, he didn't die in peace and apparently they're not going to let him rest in peace.""",2016-06-23 12:52:00,link,18,19,23,60
10513336322,"""In a chamber governed under strict rules and decorum, it was a moment that defied all precedent.""",2016-06-23 20:20:00,link,192,18,33,243
52150999700,We're digging Nick Jonas' new sound. 👌🏼,2016-06-18 08:31:00,link,39,93,50,182
86680728811,Texas man charged with manslaughter after his 6-month-old daughter was found unresponsive outside their home.,2016-06-22 03:03:32,link,26,73,29,128
75932763901,John Travolta doesn't look like this anymore! See his drastic transformation (via Closer Weekly) —> http://bit.ly/1NDCkYS,2016-06-19 11:30:00,photo,150,57,33,240
5281959998,"Mother: ""We should look after our own first. Charity begins at home.""
Daughter: ""But we are all people! We should help each other.""",2016-06-21 02:25:21,link,37,62,40,139
52150999700,"This is all kinds of adorable, Ellen DeGeneres. ❤️",2016-06-15 10:09:00,link,70,1,45,116
112638779551,"Tristan Thompson was a beast on the boards for the Cleveland Cavaliers, who forced a Game 7 in the NBA Finals.",2016-06-17 12:12:56,link,67,86,13,166
75932763901,"Michael Douglas and Catherine Zeta-Jones' kids, Dylan and Carys, are SO grown up! Wait until you see them now (Closer Weekly) —> http://bit.ly/1S5Vg3d",2016-06-16 01:00:00,photo,31,62,45,138
7245371700,"Move over men, of Westeros.",2016-06-20 20:13:00,link,192,62,36,290
25902406772,Tim Tebow isn't counting out a return to the NFL.,2016-06-15 15:21:22,link,71,44,23,138
112638779551,Charles Barkley wants to bring Nick Saban to Cuba and leave him there.,2016-06-15 12:34:52,link,125,24,30,179
5281959998,"""If we are taken out of the EU then a lot of Scots would want to be taken out of the UK.""",2016-06-17 03:26:58,link,129,86,4,219
95926963131,"Seven years after his death, Michael Jackson is in the news again.",2016-06-22 17:39:04,link,62,93,28,183
10606591490,"""For years my three kids were just faces on the other side of the glass or voices over the phone.""",2016-06-17 10:00:52,link,190,51,45,286
86680728811,"JUST IN: Marco Rubio will run for reelection to his Florida Senate seat, sources say.",2016-06-22 09:15:03,link,68,98,12,178
10606591490,"It's almost always some version of ""I'm not telling you.""",2016-06-15 06:00:37,link,174,41,1,216
5281959998,"A prime place to see watermelon snow? A glacier in Svalbard ""where there are no worries about what happens back home.""",2016-06-23 20:25:00,link,161,17,40,218
95926963131,These photos will change your world. (via PEOPLE Pets),2016-06-20 03:00:23,link,115,26,27,168
112638779551,Everything you need to know as U.S. Soccer gets set to battle for a spot in the Copa América Centenario 2016 semifinals.,2016-06-16 14:15:00,link,119,60,2,181
10606591490,Try this tactic.,2016-06-19 19:30:03,link,8,40,40,88
18807449704,The cutest Cheerios challenge EVER 😍,2016-06-21 05:58:29,link,143,60,31,234
25902406772,The NBA draft is almost upon us!,2016-06-23 14:23:28,link,189,73,41,303
18807449704,SO MESMERIZING.,2016-06-19 14:27:00,link,193,87,29,309
10606591490,Because red wine is so passé.,2016-06-20 05:30:34,link,146,97,5,248
112638779551,"""I'm just hanging in there."" - First round U.S. Open Championship co-leader Andrew Landry chats with Shane Bacon about grinding through his second round. #USOpen",2016-06-18 11:38:05,video,116,16,25,157
112638779551,Hold the phone. Cleveland Cavaliers forward Richard Jefferson may have just taken back his plans to call it a career.,2016-06-22 17:09:48,link,156,6,42,204
18807449704,😭 😭 😭,2016-06-23 03:57:02,link,176,87,21,284
10606591490,1. Dark chocolate.,2016-06-18 16:30:26,link,29,11,15,55
95926963131,It turns out Kim Kardashian West is pretty hardcore. (via People Great Ideas),2016-06-20 07:00:56,link,81,34,48,163
13652355666,Charlotte is officially a big sister.,2016-06-18 11:43:13,link,85,26,34,145
10513336322,"""When we first picked Bankside for the Tate Modern, people argued that if you were going to save a Gilbert Scott building, it should be Battersea Power Station. We looked at Battersea, but it was in private hands and they were asking too much. And even I thought it would have been too big! Who would have believed we would get double the expected number of visitors and, 16 years later, be expanding massively.""",2016-06-21 09:20:00,link,28,27,38,93
52150999700,This director is no stranger to biopics.,2016-06-15 03:59:00,link,140,97,20,257
52150999700,Me Before You is under fire from these serious activists.,2016-06-17 14:56:00,link,94,2,9,105
13652355666,The tale of a father who eventually cuts his son's hand off topped the list.,2016-06-19 11:12:00,link,66,97,46,209
86680728811,Helmet-cam video shows mountain biker slamming into bear at full speed then flying over his handlebars.,2016-06-21 00:06:06,link,39,30,41,110
112638779551,JR Smith still wasn't wearing a shirt when the Cleveland Cavaliers landed back home. He's the best.,2016-06-20 12:53:23,link,173,5,8,186
75932763901,HEARTBREAKING news for Gwen Stefani and Blake Shelton — get the details: http://bit.ly/290D1z1,2016-06-24 02:15:00,photo,15,53,32,100
95926963131,These moms are sharing their breastfeeding journey.,2016-06-17 16:54:04,link,177,4,11,192
5281959998,The Titanic was sailing from England to the U.S. So why are the victims buried in Canada?,2016-06-17 14:25:09,link,158,41,26,225
86680728811,"Three businesses donated their services, including an animal transport company, a courier service and an Australian airline, to get the frog to a treatment facility more than 700 miles away: http://abcn.ws/1Yr3VEs",2016-06-15 08:30:00,link,200,86,2,288
5281959998,"""What a total, utter freak show this promises to be,"" Frank Bruni writes in The New York Times Opinion Section, ""and not in the manner that Republicans feared just months ago.""",2016-06-19 12:55:00,link,88,65,40,193
86680728811,"How hot has it been in Arizona? Hot enough to fry a steak in the street – and to bake cookies on the dashboard of an exotic car for dessert.  http://abcn.ws/28P3rpW

CREDIT: When in Arizona",2016-06-21 23:32:38,video,153,48,6,207
95926963131,The British lawmaker was brutally murdered in an attack near where she regularly meets constituents.,2016-06-16 13:59:03,link,136,85,16,237
75932763901,RIP! Our hearts are with this actor's loved ones during this difficult times —> http://bit.ly/1PzDIg3,2016-06-18 09:30:00,photo,112,85,42,239
18807449704,Whoops.,2016-06-21 02:00:00,link,23,69,20,112
10513336322,Scientists are showing that the runner's high and the yogi's tranquility have profound effects on your brain.,2016-06-18 05:40:00,link,161,65,25,251
10513336322,"""The European Union is a festering cesspool of undue influence and opaque lobbying. By comparison with the British system, however, this noxious sewer is a crystal spring. Every stream of corporate effluent with which the EU poisons political life has a more malodorous counterpart in the UK.""",2016-06-15 02:00:00,link,158,73,39,270
7245371700,"Keep doing you, Kendall Jenner.",2016-06-16 13:52:22,link,76,30,1,107
7245371700,She hasn't taken a day off in a year?,2016-06-20 17:39:59,link,48,96,32,176
13652355666,#summergoals 🏀,2016-06-21 16:25:00,video,109,73,37,219
112638779551,Let's consider the options and what's at stake.,2016-06-17 15:21:45,link,193,45,2,240
112638779551,"Listen to Kofi Kingston recite Stone Cold's iconic ""Austin 3:16"" speech, which Austin delivered 20 years ago today.",2016-06-23 15:01:12,link,164,6,2,172
112638779551,"""If I driving it like I am, I'm going to be tough."" - Dustin Johnson assess his U.S. Open Championship chances. #USOpen",2016-06-17 20:03:20,video,147,74,19,240
18807449704,This is what paranoia looks like.,2016-06-21 19:41:39,link,124,63,25,212
95926963131,A hot day turned tragic for this twin boy and girl. (via People True Crime),2016-06-21 08:57:05,link,50,22,49,121
13652355666,We can't even.,2016-06-23 01:15:00,link,198,48,49,295
7245371700,Liam Hemsworth and his team take on the aliens in Independence Day tomorrow!,2016-06-23 19:00:00,photo,53,52,13,118
112638779551,Chicago Bulls continue their makeover ... and may not be done making moves,2016-06-23 20:50:27,link,139,46,16,201
5281959998,"""Today's search warrant might have prevented a deadly, violent incident, like the one we recently saw in Orlando.""",2016-06-17 11:25:00,link,196,75,46,317
52150999700,"This is NOT a drill, The Flash fans! 😱 ⚡️",2016-06-20 12:13:44,link,138,54,2,194
25902406772,Pittsburgh Penguins star Sidney Crosby with a well-deserved shave.,2016-06-17 19:35:31,link,186,65,16,267
75932763901,BABY JOY! See which famous actress just became a grandma to this adorable little boy (via Closer Weekly) —> http://bit.ly/28NOWRf,2016-06-22 22:30:00,photo,126,44,42,212
86680728811,Michael Sandford allegedly told a United States Secret Service agent that he had driven from California to Las Vegas to kill Donald J. Trump.,2016-06-20 18:20:54,link,160,87,14,261
5281959998,"When Dr. Joseph Ibrahim, a trauma surgeon, heard that the Orlando attack may have been linked to terrorism, he caught himself fearing any kind of link to his own Muslim, Middle-Eastern roots.

Please, he thought, don't let Ibrahim appear anywhere in the gunman's name.",2016-06-16 19:25:00,link,81,73,46,200
25902406772,Players completed the second round and most of the third round at the 2016 U.S. Open on Saturday at Oakmont Country Club.,2016-06-18 21:30:02,link,99,4,42,145
10606591490,"""Woo! Ha ha! I see patterns where none exist!""",2016-06-15 10:30:04,link,104,90,25,219
95926963131,The Nanny actress Ann Morgan Guilbert has died at age 87.,2016-06-15 22:39:31,link,181,74,37,292
86680728811,Aircraft attempting to rescue at least one sick person from the South Pole is being held up because of harsh weather -- the last leg of a harrowing rescue mission that involves landing without a runway in darkness.,2016-06-20 18:47:36,link,85,46,45,176
95926963131,The NASCAR veteran will never forget the family outing that turned savage.,2016-06-20 19:08:04,link,84,64,23,171
112638779551,"Everyone knows who the Chicago Bulls selected with the 3rd pick in the '84 NBA Draft, but do you know who Chicago selected with the 208th pick? #betcha",2016-06-22 13:36:24,video,19,74,10,103
25902406772,The Pittsburgh Pirates are in some trouble.,2016-06-17 19:47:33,link,143,68,38,249
10513336322,Senior government officials fear the violence unleashed by Russian hooligans at Euro 2016 was sanctioned by the Kremlin and are investigating links with Vladimir Putin's regime.,2016-06-19 05:20:00,link,65,6,47,118
5281959998,The Orlando shooting has sparked a lot of discussion on our Facebook page and on nytimes.com. We've gathered a group of college students to discuss some of their reactions to the shooting.,2016-06-16 17:48:15,video,12,94,50,156
10606591490,"""Just another day on the job in Florida, which has recently given us a slew of alligator sightings.""",2016-06-15 23:00:36,link,120,72,34,226
86680728811,"British Prime Minister David Cameron on the death of lawmaker Jo Cox: ""The death of Jo Cox is a tragedy. She was a committed and caring MP."" http://abcn.ws/1UbiBCT",2016-06-16 12:17:21,photo,166,28,17,211
7245371700,Can't wait to see Tyler Hoechlin take flight.,2016-06-16 15:56:04,link,145,90,39,274
112638779551,Cincinnati Reds outfielder Billy Hamilton made a ridiculous diving catch Saturday,2016-06-18 19:01:49,link,61,18,38,117
25902406772,Ben Simmons is headed to the Philadelphia 76ers.,2016-06-23 18:40:56,link,179,16,11,206
75932763901,WHAT? Find out what Teen Mom 2 star Kailyn Lowry is saying about syphilis —> bit.ly/1W4CWxp,2016-06-19 23:30:00,photo,92,51,34,177
13652355666,There is one catch: All technology is strictly forbidden.,2016-06-21 19:55:00,link,131,92,33,256
112638779551,"""It's like a marriage or a girlfriend.""

LeBron James explains his deep love for the Cleveland Cavaliers coach.",2016-06-17 11:19:59,link,74,35,49,158
86680728811,"UPDATE: One body found during search in the Gulf of Mexico for a father and his three teenage children, who have been missing since Sunday, U.S. Coast Guard confirms.",2016-06-22 14:03:09,link,52,63,33,148
86680728811,Portion of Orlando shooter's calls with hostage negotiators will be released Monday.,2016-06-19 09:34:52,link,82,33,44,159
112638779551,Michigan Football head coach Jim Harbaugh explains why he doesn't miss the NFL.,2016-06-23 12:48:50,link,63,92,33,188
95926963131,Chelsea Clinton is home bound with a new bundle of joy! (via People Babies),2016-06-20 16:34:06,link,32,66,30,128
10513336322,Multiball mode enabled.,2016-06-22 06:30:00,link,132,27,40,199
10513336322,The Guardian advocates voting remain in Thursday's EU referendum. Here's what you can do to support the cause,2016-06-21 01:00:01,link,63,2,11,76
25902406772,The final round is set. REMATCH.,2016-06-22 23:15:59,photo,109,44,34,187
52150999700,The View's bittersweet announcement note describing the comedienne is so on point. 🙏,2016-06-16 19:04:01,link,17,34,46,97
7245371700,Iggy Azalea wrote a pretty cordial message about the break-up.,2016-06-20 08:17:19,link,68,1,28,97
10606591490,Britain's leading broadcasters all predict a Brexit vote.,2016-06-23 23:30:06,link,85,82,15,182
5281959998,Yuliya Stepanova is a brave whistle-blower on organized doping in Russian athletics. She should be allowed to participate in Rio. Read on in The New York Times Opinion Section.,2016-06-17 09:25:00,link,192,55,47,294
25902406772,Very tough luck for the Detroit Tigers.,2016-06-16 23:39:03,link,60,76,20,156
13652355666,Good thing it's iced coffee season?,2016-06-16 07:38:00,link,68,90,28,186
10513336322,"Never mind the racing, just park up and enjoy the view.",2016-06-21 09:10:00,link,154,71,25,250
18807449704,Not so fast...,2016-06-15 05:46:29,link,38,86,1,125
86680728811,"WATCH: Donald J. Trump: If some people in Pulse nightclub had been armed, ""it would have been a whole different story."" http://abcn.ws/21sGVnO",2016-06-18 14:41:00,video,182,77,35,294
7245371700,"""My hermanos and hermanas went to Pulse with the knowledge and comfort that they would be understood there, that they would be en casa.""",2016-06-15 13:14:35,link,2,18,49,69
75932763901,"Just months after welcoming Baby No. 1, Anne Hathaway has received some more VERY exciting news! Get the full story (via Closer Weekly) —> http://bit.ly/1Uf3hKE",2016-06-17 01:00:00,photo,196,41,10,247
25902406772,LeBron James finally opens up about his secret motivation.,2016-06-20 09:22:25,link,107,1,19,127
10606591490,From Gisele Bündchen to Michelle Obama .,2016-06-19 21:00:31,link,99,23,47,169
10513336322,"Five key questions, on five fundamental issues, that are well worth considering before polling day.",2016-06-22 04:00:01,link,141,82,34,257
7245371700,"Good choice, Kendall Jenner.",2016-06-17 12:49:12,link,194,51,32,277
25902406772,"Dustin Johnson may or may not have committed a violation, and his fellow golf stars have plenty to say about it.",2016-06-19 18:12:19,link,49,65,34,148
7245371700,Can't wait to watch the bands battle it out.,2016-06-17 11:32:14,link,128,69,1,198
13652355666,"David Beckham has some strong feelings about ""Brexit.""",2016-06-21 07:19:00,link,183,79,28,290
18807449704,A+ resume.,2016-06-20 10:03:11,link,21,77,12,110
25902406772,Well that probably has to sting a little.,2016-06-20 10:52:32,link,158,33,26,217
7245371700,I can't listen to these without laughing.,2016-06-16 06:28:08,link,183,85,10,278
95926963131,Katherine Heigl is sharing the sweet story of how she felt after finding out she was pregnant for the first time. (via People Babies),2016-06-23 14:17:48,link,105,40,43,188
95926963131,Amber Rose is opening up about whether or not she wants to have more kids with ex Wiz Khalifa. (People Video),2016-06-17 15:48:00,video,199,79,16,294
75932763901,PREGNANT! See which stunning star can't hide her baby bump anymore (via Closer Weekly) —> http://bit.ly/1U6ZlpU,2016-06-16 04:00:00,photo,168,6,21,195
112638779551,LeBron James explains what he wants out of Kevin Love in Game 6. #NBAFinals,2016-06-15 17:55:47,video,113,43,15,171
10606591490,Most people don't know there is a simple trick to get a cheaper flight.,2016-06-23 07:30:20,link,116,15,42,173
52150999700,"As a boy, Harry Potter's Daniel Radcliffe met Donald J. Trump...and lived to tell the tale!",2016-06-21 08:15:01,link,129,1,31,161
10606591490,"Elizabeth Banks: ""Tobey [Maguire] and I are basically the same age.""",2016-06-23 09:30:05,link,91,93,12,196
13652355666,Have a lot of meetings at Starbucks?,2016-06-18 05:25:00,link,174,43,14,231
7245371700,What a week for Nick Jonas.,2016-06-15 22:49:33,link,180,21,10,211
10606591490,"""Why are you making jeans that are unrealistically small?""",2016-06-17 19:30:47,link,195,90,9,294
25902406772,"Do you feel the need? The need for speed.

This 360 video will put you inside a 100-mph Pirelli race car at Lime Rock Park.",2016-06-16 17:00:00,video,1,65,36,102
7245371700,These memes are ~Loki~ hilarious.,2016-06-19 16:52:23,link,197,54,35,286
18807449704,"Barack Obama spends Father's Day at Yosemite, presses for climate change.",2016-06-19 15:53:22,video,26,65,24,115
75932763901,CAUGHT ON TAPE: Things are heating up pretty quickly for Taylor Swift and Tom Hiddleston — and this new video proves it! —> http://bit.ly/28OgOop,2016-06-22 16:30:01,photo,113,62,41,216
75932763901,"If you think Reese Witherspoon's daughter, Ava, looks like her famous mom in this photo, JUST WAIT until you see this pic that has everyone talking (via Closer Weekly) —> http://bit.ly/1slc4yM",2016-06-18 06:45:00,photo,96,4,49,149
75932763901,CONGRATS! This famous lady just welcomed a baby girl named Shane! FInd out who —> http://bit.ly/28PTjhL,2016-06-22 13:30:03,photo,88,50,45,183
25902406772,No. 1 overall pick Jared Goff is No. 2 on the Rams' QB depth chart.,2016-06-17 14:54:53,link,17,58,39,114
95926963131,Wounded survivors of the Orlando Pulse nightclub shooting speak out in this heartbreaking video. (via People True Crime),2016-06-17 05:00:00,video,120,60,25,205
7245371700,Take your pick for Best New Fandom of the Year at the Fandom Awards: http://fandom.mtv.com,2016-06-22 11:02:00,photo,56,3,46,105
75932763901,CONGRATS! Click here to find out who welcomed a baby girl named Shane —> http://bit.ly/28PTjhL,2016-06-22 23:00:00,photo,181,35,25,241
95926963131,Kendall Jenner and Gigi Hadid are totally twinning! ( via PeopleStyle),2016-06-23 04:00:35,link,73,83,24,180
10513336322,"'For example, if the other person pushes for a date, Ghostbot might reply: ""Nope,"" ""I just have no time right now,"" or ""Sorry, just me and 🍕 tonight."" This continues until the pestering messages peter out.'",2016-06-22 09:20:00,link,78,20,11,109
112638779551,"Patrick Cote has a few harsh words for Donald ""Cowboy"" Cerrone ahead of their fight in the UFC this Saturday.",2016-06-16 13:32:12,link,160,92,16,268
52150999700,"Jared Leto, Margot Elise Robbie and the rest of the gang LOVE to be bad in Suicide Squad. 👊🏼",2016-06-21 12:42:36,link,2,83,46,131
75932763901,HUGE BABY NEWS for Nicole Kidman and Keith Urban! Get the exciting details (via Closer Weekly) —> http://bit.ly/24DYFjy,2016-06-24 00:00:00,photo,128,39,5,172
25902406772,The Boston Celtics turned some heads at No. 3.,2016-06-23 19:20:23,photo,52,52,7,111
10513336322,"""While there are good reasons for British voters to either support or oppose the proposed withdrawal of the UK from the European Union, there is little argument at all from an American perspective that Brexit would hurt the US.""",2016-06-23 20:40:00,link,86,92,40,218
18807449704,So in love. 😍,2016-06-15 23:30:00,link,108,22,32,162
112638779551,"Stephen Curry didn't get to congratulate LeBron James after Game 7, but here's what he hoped to tell him.",2016-06-20 09:39:31,link,125,51,15,191
13652355666,"""With Brexit and Trump, the disrupters have become exigent threats,"" Wolff rights.",2016-06-20 04:40:00,link,186,91,15,292
112638779551,"""I'm not the average guy.""

Dwight Freeney is asking NFL teams to give him a chance.",2016-06-15 11:59:30,link,29,57,32,118
10606591490,Extra bouncy.,2016-06-20 06:30:10,link,113,63,13,189
10606591490,Looking to phase out a relationship? Ghostbot is here to help.,2016-06-22 22:30:23,link,65,78,2,145
86680728811,"Orlando shooter Omar Mateen wrote of how much he appreciates being raised in a ""safe country and society"" and detailed his ""respect and admiration"" for law enforcement in a handwritten police academy application: http://abcn.ws/1UCkvA8",2016-06-18 10:15:11,link,195,82,5,282
5281959998,An oppressive heat wave has been blamed for the deaths of four hikers in Arizona.,2016-06-20 15:55:00,link,3,92,6,101
7245371700,Kim Kardashian West was the best dressed in all of the ~ sea ~,2016-06-20 11:37:38,link,199,30,45,274
52150999700,Ben Affleck proved his loyalty to the New England Patriots last night.,2016-06-23 06:59:01,link,196,78,16,290
95926963131,"Happy birthday, Prince William! From pampered little prince to a world-class Prince Charming, see the future king of England's startling transformation.",2016-06-21 17:53:00,video,27,71,37,135
95926963131,Orlando shooting victim Luis Vielma is remembered as a beloved member of his community and an irreplaceable friend. ❤️,2016-06-15 15:08:17,link,45,74,34,153
75932763901,"Do you remember when Brooke Hogan was the 'it' girl of the early 2000's?! Well since staying out of the spotlight, she looks TOTALLY different! See her now –> http://bit.ly/1sGPzVa",2016-06-17 11:03:13,photo,131,47,47,225
10513336322,"This summer Brits have faced questions from anxious fellow citizens of the European Union. A month ago it was: ""Your referendum, it will be OK, yes?"" The more reproachful version has become: ""Why are you doing this to us?""",2016-06-18 08:00:00,link,89,3,28,120
18807449704,This is going to revolutionize your Instagram game...,2016-06-17 07:00:00,link,32,14,15,61
18807449704,"Something to keep in mind, Game of Thrones fans.",2016-06-18 11:15:00,link,4,90,43,137
52150999700,"This week's Silicon Valley episode reminds you of the ""Chairs are like Facebook"" ad.",2016-06-19 20:41:00,link,66,14,9,89
5281959998,"""You don't see fat weasels.""",2016-06-20 03:25:00,link,81,19,33,133
10606591490,Martha Stewart threw some serious shade at Kim Kardashian West's best friend.,2016-06-22 18:31:22,link,68,53,13,134
75932763901,We can't believe how grown up her little ones look already!,2016-06-17 01:30:00,link,154,71,32,257
10606591490,Their ages ranged between six months to 18 years old.,2016-06-19 20:30:24,link,159,87,4,250
13652355666,Hold the phone: House Dems #HoldTheFloor,2016-06-22 18:10:00,link,26,44,34,104
25902406772,Denver Broncos fans have seen it all.,2016-06-23 10:01:03,link,58,76,12,146
112638779551,Rory McIlroy showed just how difficult Oakmont's greens are by accidentally draining this ridiculous putt.,2016-06-15 13:56:25,link,150,23,30,203
7245371700,"Whoa, that's a lot of dough.",2016-06-15 13:42:50,link,76,49,21,146
75932763901,"BABY BOMBSHELL: Just days after setting a date for their wedding, Blac Chyna and Rob Kardashian share HUGE baby news! —> http://bit.ly/28SbvFz",2016-06-24 12:30:00,photo,32,92,49,173
86680728811,"The oldest living president led a group of 40 wounded warriors on a fishing trip at the helm of his speedboat, just three days after his 92nd birthday. http://abcn.ws/1Q7OcJb",2016-06-16 08:42:06,link,184,34,39,257
25902406772,Well... that's random to say the least.,2016-06-17 11:48:48,link,46,42,28,116
86680728811,Pope Francis pets a tiger during Vatican Jubilee for traveling circus performers. http://abcn.ws/1Yv5zVF,2016-06-16 14:18:06,video,183,44,41,268
112638779551,Jordan Spieth's second shot at last year's U.S. Open Championship at Chambers Bay was the shot of the tournament. #USOpen #LookAgain,2016-06-19 15:46:08,video,33,49,37,119
25902406772,The Minnesota Timberwolves had some luck with their latest pick from the Kentucky Wildcats.,2016-06-21 20:31:04,link,139,73,27,239
95926963131,One of the 49 Orlando victims was honored by her 11 children as she was laid to rest on Monday.,2016-06-21 10:47:07,link,2,94,7,103
5281959998,"As play continues for Czech Republic vs. Turkey and Croatia vs. Spain, follow real-time updates on how teams can advance to the UEFA EURO CUP 2016 knockout round.",2016-06-21 13:45:00,link,166,43,32,241
86680728811,"With only 3 days left until British voters decide whether the UK will stay in or leave the European Union, polls predict a close race.",2016-06-20 15:31:25,link,16,13,48,77
112638779551,"It all comes down to one game, and these four key factors will go a long way to deciding to the 2016 NBA Champion.",2016-06-18 18:27:33,link,171,91,4,266
112638779551,"Cleveland Cavaliers fans: Here's where you need to be Monday.

Plus championship parade info.",2016-06-20 00:22:14,link,58,71,16,145
10513336322,"Martin Jennings statue of Mary Seacole will be the first named memorial statue of a black woman in the UK, so why did it take seven years to get funding, and why are The Nightingale Society objecting on the grounds that she was mixed race?",2016-06-21 13:00:01,link,44,81,41,166
5281959998,The Senate approved an expansive military policy bill that would for the first time require young women to register for the draft.,2016-06-15 18:25:00,link,94,69,42,205
95926963131,Anton Yelchin led a fascinating life before his tragic and untimely death on Sunday.,2016-06-20 18:24:06,link,129,93,29,251
112638779551,"#Betcha didn't know that the world's best golfer almost enrolled at East Tennessee State. 

--> http://foxs.pt/1Uf2fyr",2016-06-16 14:03:36,video,187,69,38,294
112638779551,Bruce Arians opens up about how The Pittsburgh Steelers forced him out.,2016-06-17 15:03:54,link,2,34,30,66
25902406772,Mexico gets the full social media treatment.,2016-06-18 23:55:28,link,139,95,3,237
95926963131,"David Hiden, who nearly lost his own son a year ago at Disney, is speaking out.",2016-06-21 15:35:04,link,74,18,23,115
95926963131,Over-the-top July 4th milkshake FTW! (via People Food),2016-06-23 13:55:02,video,95,23,40,158
95926963131,Ellen DeGeneres has fans of all ages! ❤️,2016-06-16 19:36:01,video,159,36,43,238
7245371700,Orange Is the New Black presents us with a variety of femalehood + storylines — but is the show getting too broad?,2016-06-17 14:22:44,link,118,78,7,203
95926963131,Massachusetts native Ben Affleck is a diehard Boston sports fan – and he's not afraid to stand up for his team.,2016-06-23 11:20:15,link,179,50,26,255
25902406772,Thing's are really starting to heat up.,2016-06-17 17:23:29,link,116,68,38,222
7245371700,"We need answers, Disney.",2016-06-15 16:22:28,link,138,22,30,190
25902406772,"Based on Simmons' latest social posts, it's true.",2016-06-21 12:19:10,link,106,32,40,178
5281959998,"A former SS guard at Auschwitz was sentenced to five years as an accessory to at least 170,000 deaths. He may be the last former Nazi sentenced for war crimes.",2016-06-17 10:27:18,link,21,14,2,37
112638779551,"""Shout-out to JC Penny!"" 

No. 5 overall pick Kris Dunn talks about his custom draft night suit.",2016-06-23 20:07:54,video,5,12,13,30
25902406772,UH OH! Derrick Rose to the New York Knicks???,2016-06-22 15:09:21,link,70,4,26,100
18807449704,This is a game changer!,2016-06-16 16:24:34,link,142,53,7,202
10606591490,The Empire strikes...again.,2016-06-22 12:30:33,link,37,98,38,173
7245371700,~ Sorry ~ Spotify users.,2016-06-22 14:03:18,link,54,87,48,189
25902406772,Stephen Curry wasn't happy.,2016-06-17 00:10:03,link,179,43,50,272
13652355666,"""Do you see what's happening?""",2016-06-17 09:01:00,link,173,78,50,301
10513336322,Pakistani singer Amjad Sabri has been killed in a gun attack in Karachi.,2016-06-23 01:00:01,link,83,15,12,110
10606591490,"""You have treated me with the kindness, dignity, and respect — the love — that I very often did not deserve.""",2016-06-15 19:00:54,link,97,6,48,151
7245371700,A curated playlist of Latin dance and queer club favorites to honor the victims of the Orlando shooting.,2016-06-16 16:58:06,link,119,29,43,191
95926963131,The Orlando nightclub owner hopes the fundraising site aids the grieving community and her employees.,2016-06-16 22:50:07,link,158,35,6,199
5281959998,"""Jo Cox's legacy should be an open Britain in the European Union,"" Roger Cohen writes in The New York Times Opinion Section.",2016-06-22 02:25:00,link,77,96,11,184
75932763901,NEW COUPLE ALERT! Fans were stunned to see Hilary Duff out with THIS man (via Life & Style Weekly) —> http://bit.ly/28LHmJl,2016-06-22 02:15:00,photo,81,24,4,109
7245371700,Admiring Arya a little more considering what she pulled off.,2016-06-19 16:23:04,link,17,40,7,64
18807449704,'Matilda' star Mara Wilson comes out on Twitter as queer.,2016-06-15 19:51:00,video,156,50,24,230
7245371700,Laci Green and Morgan Evans have a hilarious discussion about whether size matters.,2016-06-18 12:00:00,video,160,25,8,193
5281959998,"No, not to lose weight.",2016-06-20 08:55:00,link,165,98,32,295
10513336322,"David Beckham has said he backs a vote to remain in the European Union, saying he wants his children to grow up ""facing the problems of the world together and not alone"".",2016-06-21 05:20:07,link,147,2,14,163
112638779551,"""An extremely tough decision"" for the bright young Notre Dame Fighting Irish Athletics wide receiver.",2016-06-15 17:21:47,link,167,64,43,274
75932763901,SO CUTE! Find who this adorable baby girl belongs to! —> http://bit.ly/1W1F1el,2016-06-16 12:00:00,photo,76,19,20,115
18807449704,"10 years ago today, this YouTuber changed the web forever.",2016-06-16 15:20:20,link,12,52,32,96
86680728811,Hillary Clinton has $42 million in cash on hand. Donald J. Trump has $1.3 million.,2016-06-21 08:48:52,link,67,50,11,128
75932763901,They dated for TWO DAYS before getting married! See who (via Closer Weekly) —> http://bit.ly/1TPD1FR,2016-06-21 07:15:00,photo,99,57,38,194
75932763901,TOO CUTE FOR WORDS! Kim Kardashian West just shared a new photo of Saint West — and it is EVERYTHING: http://bit.ly/28TDas2,2016-06-23 18:00:00,photo,82,69,28,179
75932763901,She begged Tyga to delete the X-rated footage...,2016-06-20 20:00:00,link,81,53,1,135
112638779551,The Internet had a lot of fun Andrew Wiggins new signature shoe.,2016-06-16 17:22:00,link,71,70,12,153
112638779551,"And we can't wait to see you tomorrow, Ángel Cabrera! #USOpen",2016-06-16 17:17:36,photo,174,42,9,225
13652355666,The school is reeling.,2016-06-20 21:15:01,link,128,48,1,177
13652355666,Warning: graphic photo from incident,2016-06-19 21:40:00,link,99,95,5,199
86680728811,"""We did this to coincide with his visit to show solidarity with the Mexican people and many other groups that Donald J. Trump has lied to and intimidated, because we've experienced it.""",2016-06-21 13:07:37,link,127,83,12,222
7245371700,Christy Carlson Romano has a new Even Stevens member on the way!,2016-06-23 15:46:59,link,62,59,14,135
95926963131,"The autopsy confirming the boy's identity as 2-year-old Lane Graves of Elkhorn, Nebraska, was completed on Thursday afternoon.",2016-06-16 17:13:03,link,78,19,6,103
75932763901,CONGRATS! Click here to find out who welcomed a baby girl named Iris Mary! —> http://bit.ly/28ILBSc,2016-06-20 13:30:01,photo,165,7,5,177
10513336322,Big Brother prompted another Ofcom inquiry after contestants Laura Carter and Marco Pierre White Jr were involved in some of the most explicit sex scenes in the show's 16-year history.,2016-06-20 07:00:00,link,50,30,15,95
18807449704,"If you leave your child alone with a dog and a pot of nail polish, you should be prepared for the consequences.",2016-06-21 08:08:20,link,123,59,15,197
75932763901,BAD PARENTING?! This picture of Snooki and JWOWW's kids might look innocent – but when you read the caption you'll understand why some fans are MAD! –> http://bit.ly/1tukWSs,2016-06-17 17:30:00,photo,104,98,49,251
95926963131,J.K. Rowling sent a message of sympathy to a late member of her Harry Potter family.,2016-06-18 17:20:10,link,148,86,23,257
10513336322,"'Angela tells me that, in her case, jobcentre advisers focus on her husband's having had a ""miraculous"" recovery from ME, or on what she'll do if he dies. ""He's sitting next to me when they say that,"" she adds.'",2016-06-18 02:00:00,link,56,1,23,80
25902406772,When arm wrestling meets Rutgers Football.,2016-06-16 09:27:44,link,153,95,22,270
5281959998,"""I didn't believe it,"" Alberto Capo said, sobbing after seeing the coffin of his nephew. ""I did not believe it at all, whatsoever. I see him in that box and it's just totally different.""",2016-06-16 23:25:00,link,71,22,46,139
25902406772,"Rory McIlroy, Dustin Johnson and Andrew Landry stood out at Oakmont.",2016-06-20 12:53:45,link,121,28,13,162
10513336322,"""Divorced and living alone, I can well understand the fears that spring up when you look to your future and see a path with only one set of footsteps. But instead of panicking about life without a soulmate, I think it's more helpful to recognise that it's highly unlikely you'll be single forever, but also to be realistic about the fact that you may not share your whole life with just one person.""",2016-06-15 05:20:00,link,127,43,23,193
10606591490,Going for a run?,2016-06-19 12:01:00,link,5,98,41,144
13652355666,Wow. Oakland has gone through three police chiefs in eight days after scandals from illicit sex to racist texts http://usat.ly/24X0qWA,2016-06-18 18:01:00,video,12,75,39,126
25902406772,Just a little friendly Brazilian banter.,2016-06-23 12:59:34,link,199,96,6,301
112638779551,WATCH: Felice Herrig takes a second run at the American Ninja Warrior obstacle course.,2016-06-23 17:34:48,link,158,62,47,267
112638779551,How about a LEGO model of Daytona International Speedway?,2016-06-20 14:34:17,link,64,11,45,120
112638779551,"One. Step. Closer.

Kobe Bryant sets the stage for U.S. Soccer vs Ecuador in the Copa América quarterfinals, tonight at 8pm ET on FS1! #Copa100 #MyCopaColors",2016-06-16 17:51:27,video,176,31,22,229
10513336322,"""Taping over sensors might seem paranoid. But to be fair to Mark Zuckerberg, he's not the only one taking a look at his webcam and wondering if it's worth the risk.""",2016-06-22 07:40:00,link,38,57,35,130
25902406772,UH OH. JR Swish will be testing free agency.,2016-06-16 12:17:37,link,175,49,37,261
18807449704,Being a secret stoner has never been easier.,2016-06-15 20:15:19,link,129,97,41,267
52150999700,Clark is the prime suspect in a murder on this week's Bones. 😱,2016-06-23 20:24:00,link,103,23,21,147
18807449704,Cheers! 🍻,2016-06-16 09:12:45,link,37,47,3,87
95926963131,This list will help you decide where to shop from now on! (via PeopleStyle),2016-06-18 08:00:57,link,33,83,7,123
5281959998,It's about Britain's place in the world and the future of the European project.,2016-06-20 04:28:39,link,153,45,32,230
52150999700,The world's first The Golden Girls cafe will be where everyone thanks you for being a friend. ❤️,2016-06-21 15:53:01,link,94,27,2,123
7245371700,"Hey Everyone, it's Jenna from The Challenge answering your questions LIVE and dropping the mid-season trailer for RIVALS III! Don't miss tonight's episode at 10/9c :)",2016-06-15 12:22:45,video,106,92,40,238
5281959998,"While you're watching Ukraine on the field during UEFA EURO 2016, see in real time its chances of advancing to the next round.",2016-06-21 10:30:00,link,23,60,50,133
25902406772,The Philadelphia 76ers are making some serious moves.,2016-06-23 12:18:01,link,164,74,18,256
18807449704,Cristiano Ronaldo will NOT back down.,2016-06-22 17:25:19,link,100,58,28,186
112638779551,"Whaaaaaaat?! We don't think anyone in the NBA Draft can do this. 

Rachel Bonnetta for @TheBuzzer",2016-06-23 18:09:50,video,197,39,42,278
95926963131,"Wedding season is upon us, and even the royals are feeling the bridal fever! (via People Royals)",2016-06-17 16:10:07,link,135,73,24,232
7245371700,Taylor Swift's stationary collection is kinda bomb.,2016-06-19 02:59:46,link,188,91,43,322
86680728811,FBI planning to release portions of conversations between Orlando shooter Omar Mateen and police during the deadly assault that left 49 people dead.,2016-06-20 08:49:19,link,40,73,43,156
86680728811,The Statue of Liberty arrived in New York Harbor on this day in 1885. http://abcn.ws/1UTo2Zn,2016-06-17 18:51:12,video,175,55,21,251
25902406772,The former Dallas Cowboys RB is facing more problems.,2016-06-22 08:40:16,link,1,26,7,34
7245371700,Does LeBron James's championship win for the Cleveland Cavaliers mean a new JAY Z album?,2016-06-21 14:13:19,video,63,98,40,201
112638779551,"On the final day of minicamp, New York's coach says he's not answering any more questions about the free-agent quarterback.",2016-06-16 14:17:56,link,64,53,25,142
18807449704,Cannot. Cope.,2016-06-22 08:00:00,link,3,78,19,100
7245371700,And she looked incredible in all of them.,2016-06-20 15:04:33,link,112,92,22,226
95926963131,The 52-year-old's personal victory is also an important development for transgender Americans.,2016-06-15 16:01:31,link,106,28,30,164
75932763901,"""I took my weight off the old-fashioned way. I like to call it the Just Keep Your F---ing Mouth Shut and Eat Air diet."" See which famous mama admitted to starving herself to lose her baby weight —> http://bit.ly/28SVX6D",2016-06-24 00:30:00,photo,163,70,49,282
75932763901,WEDDING BOMBSHELL! Click here for Teen Mom 2 Chelsea Houska's exciting news —> http://bit.ly/28IYw6i,2016-06-20 16:00:00,photo,9,86,13,108
7245371700,Bella Thorne's new look is v brave & v bold.,2016-06-22 00:45:11,link,192,96,6,294
95926963131,Ayesha Curry is making her feelings about tonight's game between the Golden State Warriors and Cleveland Cavaliers very clear.,2016-06-17 07:44:05,link,109,58,33,200
86680728811,"JUST IN: Cockpit voice recorder from crashed EGYPTAIR flight MS804 has been located, Egypt's Ministry of Civil Aviation says. http://abcn.ws/1Pw7lyT",2016-06-16 08:32:22,link,43,2,39,84
25902406772,Tom Brady definitely is not the king of Snapchat.,2016-06-18 15:27:41,link,191,45,4,240
18807449704,It was breathtaking,2016-06-20 05:30:00,link,46,32,37,115
25902406772,Seattle Seahawks QB Russell Wilson and Ciara are turning into a power couple.,2016-06-17 17:10:34,link,64,9,40,113
18807449704,Things can turn pretty ugly at the gym.,2016-06-19 20:00:00,link,41,8,49,98
7245371700,Gigi Hadid has Zayn's back.,2016-06-15 04:18:39,link,57,57,42,156
10606591490,The 5 most interesting moments of the House sit-in. http://ti.me/28SeyjP,2016-06-23 20:15:57,video,13,37,4,54
112638779551,LeBron deserves to win the Finals MVP award. But he's probably not getting it if the Warriors win the title:,2016-06-17 16:20:17,link,12,55,23,90
25902406772,"Well, that's one way to end an interview...",2016-06-22 18:05:57,link,50,48,40,138
10513336322,"The UK's two leading public health bodies, representing thousands of doctors and other professionals, are making an unprecedented call for the personal possession and use of drugs to be decriminalised.",2016-06-16 03:40:00,link,33,47,49,129
10513336322,"""This is not your average ""war rape"". These are terrifying, targeted, individual attacks against the country's smallest children being perpetrated by what appears to be a powerful man and his minions, who believe – as do local Mai-Mai militia fighters – that the virgin blood of girls will fortify them for battle.""",2016-06-20 10:40:00,link,49,11,5,65
5281959998,It's a ritual that has become all too familiar to President Obama.,2016-06-16 12:38:00,link,50,9,25,84
7245371700,She's like Lizzie McGuire but all grown-up.,2016-06-16 02:56:07,link,157,89,2,248
75932763901,"If you think Reese Witherspoon's daughter, Ava, looks like her famous mom in this photo, JUST WAIT until you see this pic that has everyone talking (via Closer Weekly) —> http://bit.ly/1slc4yM",2016-06-24 05:30:00,photo,99,49,24,172
52150999700,The Force is strong with Star Wars' Ben Mendelsohn.,2016-06-17 07:23:21,link,90,75,42,207
75932763901,ANOTHER TRANSFORMATION! This is what Teen Mom star Amber Portwood looked like a month ago — but fans think she's gone too far with her newest feature! See it here —> http://bit.ly/28PJxHr,2016-06-23 16:00:00,photo,47,49,29,125
95926963131,Imran Yousuf was hailed as a hero after helping nearly 70 people escape the terror inside the Orlando nightclub.,2016-06-23 20:30:06,link,136,51,46,233
25902406772,Adam Silver is not thinking about Vegas ... yet.,2016-06-16 14:45:27,link,79,39,7,125
112638779551,The Boston Celtics are apparently being very aggressive leading up to Thursday's draft.,2016-06-21 23:30:03,link,5,37,8,50
7245371700,Kendall Jenner is giving me 🔮goth goddess🔮 vibes.,2016-06-22 11:01:32,link,157,65,24,246
10513336322,Meow.,2016-06-21 01:40:01,link,39,100,19,158
52150999700,"RIP Lois Duncan, the talented author of I Know What You Did Last Summer.",2016-06-16 19:46:10,link,132,29,22,183
112638779551,The spectacular has become somewhat routine for Toronto Blue Jays center fielder Kevin Pillar.,2016-06-21 21:45:19,link,24,56,48,128
25902406772,Russell Wilson has a new trainer.,2016-06-16 12:57:55,link,30,93,9,132
75932763901,Taking a Summer Friday tomorrow? #SeizetheDaytime and start your weekend early with #SmirnoffSourced!,2016-06-16 13:30:09,photo,54,96,12,162
86680728811,NEW THIS MORNING: Donald J. Trump and Hillary Clinton hit new highs in their unfavorability ratings in new ABC News/Washington Post poll. http://abcn.ws/1Xp8lfP,2016-06-15 07:07:18,link,123,38,47,208
5281959998,"""The People v. O.J. Simpson: American Crime Story"" and ""O.J.: Made in America"" are two of the most astonishing television series of the year, James Poniewozik writes.",2016-06-20 21:42:50,link,102,30,48,180
7245371700,"""It is crucial that people know that we are terrific human beings. It is a crucial risk to take.""",2016-06-23 21:29:01,link,2,75,2,79
112638779551,Chicago Blackhawks star Patrick Kane took home some hardware at the NHL awards ceremony.,2016-06-22 20:24:33,link,38,54,34,126
75932763901,"New mom Chrissy Teigen is normally loved by fans, but this pic shows her true personality — and when you see the full photo you'll understand why! –> http://bit.ly/1UEtfS7",2016-06-18 04:45:00,photo,122,76,3,201
7245371700,"""Right? I mean, the man wrote a song that's literally about suits and ties, therefore entering the era of 'Hot Dad.'""",2016-06-17 07:53:56,link,82,100,23,205
25902406772,Can LeBron James be stopped?,2016-06-18 14:41:28,link,173,43,26,242
52150999700,Star Trek was just one of Anton Yelchin's best roles.,2016-06-19 15:08:36,link,86,58,36,180
112638779551,Here's how the weigh-ins for UFC Fight Night in Ottawa will work this Friday.,2016-06-16 21:10:44,link,191,37,33,261
7245371700,Will the ninth season of Curb Your Enthusiasm change the course of TV comedy?,2016-06-15 18:26:43,link,156,1,40,197
95926963131,"Comfort and couture may sound like an unlikely pairing, but Blake Lively has managed to find the perfect balance. (via People Babies)",2016-06-21 16:47:07,link,129,58,26,213
7245371700,Will the ninth season of Curb Your Enthusiasm change the course of TV comedy?,2016-06-18 22:27:56,link,46,24,6,76
10513336322,"Billy Bragg: ""Those leading the push for Brexit are no friends of working people.""",2016-06-21 01:20:00,link,91,31,31,153
86680728811,Man arrested for allegedly killing neighbor and setting her apartment on fire to cover it up. Her parents had been preparing for her wedding but are instead planning her funeral.,2016-06-21 10:35:09,link,104,89,25,218
112638779551,BREAKING: New York Mets 3B David Wright will have neck surgery that could end his season.,2016-06-16 10:29:34,link,1,53,24,78
18807449704,One man's vision of a continent of cultures.,2016-06-17 01:00:00,link,125,51,30,206
52150999700,Game of Thrones' Iwan Rheon has been waiting for this moment for YEARS.,2016-06-17 11:03:42,link,2,7,5,14
25902406772,Thomas could emerge as a star.,2016-06-22 13:50:17,link,169,4,46,219
25902406772,The Carolina Panthers are keeping their coach around.,2016-06-16 16:43:41,link,142,8,19,169
25902406772,"Welcome to the New York Knicks, Derrick Rose. The Chicago Bulls acquire Robin Lopez, Jerian Grant and Jose Calderon.",2016-06-22 15:07:34,photo,195,78,29,302
5281959998,"""This myth that handwriting is just a motor skill is just plain wrong.""",2016-06-20 07:25:00,link,54,66,36,156
18807449704,Apple's stock apps will be deletable.,2016-06-20 01:00:00,link,103,23,43,169
7245371700,Almost Famous director Cameron Crowe is heading to Showtime Networks this summer with his new show Roadies.,2016-06-23 17:04:23,link,190,47,34,271
75932763901,Halle Berry's rarely-photographed daughter is all grown up! Wait until you see Nahla today (via Closer Weekly) —> http://bit.ly/25AYB7f,2016-06-17 07:15:00,photo,120,53,49,222
95926963131,"Prince, Paris and Blanket Jackson have each found their own ways to honor Michael Jackson's memory.",2016-06-22 10:18:06,link,152,20,7,179
75932763901,"Chelsea Houska is thinner than EVER today – when you see what she looked like on 16 and Pregnant, you'll be shocked at how far she's come! –> http://bit.ly/1SP2wlB",2016-06-21 18:00:00,photo,159,66,13,238
13652355666,Tim Tebow ditched a trip to the Bahamas to make the visit.,2016-06-22 14:51:00,link,5,88,27,120
7245371700,The one DCOM movie that gave me so. many. nightmares.,2016-06-20 04:00:51,link,5,63,43,111
75932763901,WTF?!,2016-06-17 21:00:00,link,122,36,46,204
18807449704,🚨 PSA: You may have free money from Apple. 🚨,2016-06-21 13:30:00,link,117,82,19,218
75932763901,We cannot believe this little lady is already one — and she's looking more and more like her famous mother every day! Find out who she is: http://bit.ly/28QghDl,2016-06-23 17:00:00,photo,20,27,15,62
7245371700,"Such a beautiful tribute, Christina Aguilera.",2016-06-19 05:22:34,link,129,77,47,253
25902406772,Miami Marlins OF Ichiro Suzuki is a hit machine.,2016-06-15 15:24:45,link,125,29,2,156
7245371700,I've always been wondering about this.,2016-06-18 15:34:51,link,185,90,17,292
13652355666,Scientists have found a planet that's similar to Luke Skywalker's home.,2016-06-15 21:31:00,link,104,40,6,150
7245371700,"And her baby pic is adorable, too.",2016-06-16 04:42:39,link,112,2,50,164
18807449704,Wait until you hear the alternative! 😂,2016-06-21 09:52:02,link,20,72,25,117
112638779551,Ever seen a cotton ball burnout? @TheBuzzer's Daryl Motte takes in a stop motion #NASCAR race.,2016-06-23 16:29:29,video,113,59,26,198
86680728811,"After hearing screaming from the front yard, the mother ran outside, where she saw the animal on top of her son: http://abcn.ws/21sH8HQ",2016-06-18 20:06:52,link,170,82,23,275
18807449704,"Millennials are young, wild and free — but not for long.",2016-06-16 00:45:00,link,166,89,5,260
25902406772,Could a reunion be looming for Jose Reyes and the New York Mets?,2016-06-20 22:47:29,link,103,90,35,228
10513336322,"These 46 projects to win a national award, which range from a grass-roofed children's hospital in Liverpool to a sinuous metallic library in Oxford, will be whittled down to a six-strong shortlist for the Royal Institute of British Architects' Stirling prize later in the year.",2016-06-23 02:40:01,link,139,7,39,185
95926963131,A case against Walt Disney World would hinge on whether or not the resort knew about the alligators living in the resort's Seven Seas Lagoon.,2016-06-16 19:10:04,link,6,99,42,147
13652355666,Unimaginable.,2016-06-23 19:23:22,link,14,23,4,41
13652355666,"""Ask yourself what can you do to make sure that Orlando or Sandy Hook never ever happens again."" http://usat.ly/1WOAT2q",2016-06-16 06:44:52,video,171,70,2,243
86680728811,"10-week-old French bulldog with special needs is making remarkable progress learning to walk with physical therapy. ""Every single day he's so much stronger than the day before."" http://abcn.ws/28JmHo7",2016-06-20 11:22:55,video,108,87,12,207
5281959998,"They are men who seemed to be building toward violent acts, and whose names had surfaced in terrorism investigations, but who avoided tipping off the authorities until it was too late.",2016-06-22 02:55:00,link,81,65,45,191
95926963131,"Kendall Jenner has had enough of the great ""supermodel debate"" about whether she and Gigi Hadid qualify for the title. (via PeopleStyle",2016-06-16 14:21:02,link,185,97,50,332
52150999700,We'll be enjoying new Prince  music for many years to come. 💜,2016-06-20 08:56:00,link,25,48,35,108
10513336322,"""How can we make our minds, which insist that we're still 22, match up with our bodies, which are twice that age? How do we get rid of the sense of having missed out? How can we stop worrying about looking silly because of our age?""",2016-06-19 09:40:01,link,146,86,21,253
112638779551,"The moment when all the blood, all the sweat & all the tears were worth it.

The Cleveland Cavaliers are CHAMPS.",2016-06-19 22:34:36,video,116,62,7,185
13652355666,"45 minutes after the first shots, Omar Mateen paused to make the call.",2016-06-15 14:40:00,link,62,64,38,164
7245371700,"He didn't have very good judgement, huh? (via AOL)",2016-06-23 11:18:07,link,24,96,20,140
86680728811,"Authorities in Florida have released an image of Lane Graves, the 2-year-old boy attacked by an alligator at a Disney World resort. http://abcn.ws/1ZSoJDQ",2016-06-15 19:59:04,photo,63,33,5,101
13652355666,The surfer turned down an offer by Brevard County Fire Rescue to go to the hospital for further treatment.,2016-06-22 05:00:00,link,73,95,39,207
18807449704,Renewable energy may become cheaper than running existing coal and gas generators by 2027.,2016-06-16 20:20:10,link,129,8,2,139
25902406772,Zeke can put the credit card away because Dez is willing to pay for his own dinners.,2016-06-22 10:47:58,link,67,61,50,178
112638779551,Consider the options and what's at stake on Sunday night.,2016-06-18 12:18:25,link,96,25,21,142
52150999700,J. J. Abrams is developing a series about Michael Jackson's final days.,2016-06-20 15:59:00,link,128,34,38,200
95926963131,Ron Lester—famous for his role as Billy Bob in Varsity Blues—is currently in critical condition.,2016-06-17 19:50:24,link,101,10,17,128
10513336322,"A survey has shown that, in the event of a crash, people think that self-driving cars should be programmed to crash themselves to avoid pedestrians – unless it's them that's in the car of course.",2016-06-23 14:40:01,link,57,86,24,167
13652355666,That's not what Donald Trump said.,2016-06-20 00:40:00,link,128,78,32,238
5281959998,"Alessandra Ferri was 21 when she danced the role of Juliet. At 53, she's doing it again.",2016-06-23 06:47:30,link,117,8,37,162
75932763901,Reese Witherspoon's daughter Ava is all grown up — and looks JUST LIKE her famous mom! Wait until you see her now (via Closer Weekly) —> http://bit.ly/1QJhIQb,2016-06-20 04:00:00,photo,84,57,35,176
10606591490,Wild.,2016-06-16 04:30:11,link,72,36,44,152
10513336322,"""I understand that it comes from an emotional place and I too felt that disgust. But I wish that people could focus the energy of leaving tirades in internet comments into volunteering in a national park, or donating to a national park instead.""",2016-06-22 03:40:00,link,43,87,44,174
5281959998,"Kelsey Lu McJunkins is a classically trained cellist who has performed with artists like Florence + The Machine, Kelela and Blood Orange. The New York Times Styles is with her at the Holy Family Roman Catholic Church in Brooklyn, where she is playing a sneak peek of her new music for us.",2016-06-16 14:32:15,video,181,31,50,262
10513336322,"John Barnes:  ""They talk about what makes Britain great. How we are morally right, the people who will do the right thing. Well that should be helping others in need, setting an example to the world – not running away at the first sign of trouble.""",2016-06-22 04:20:00,link,48,24,47,119
95926963131,Top Gun actress Kelly McGillis came home to a terrifying surprise.,2016-06-23 18:40:09,link,90,52,48,190
10606591490,Cue the 'Hotline Bling' comparisons.,2016-06-17 11:00:20,link,38,92,41,171
75932763901,CONGRATULATIONS! This famous couple will welcome their first child together thanks to IVF — it's a girl: http://bit.ly/28Jz14I,2016-06-20 17:30:00,photo,13,94,49,156
13652355666,"Trump says ""it would be nice"" if the Republican Party gets behind his candidacy, but that he'll win either way.",2016-06-19 11:07:00,link,85,47,37,169
95926963131,"Behati Prinsloo, Olivia Wilde and Candice Swanepoel are talented, gorgeous—and pregnant!",2016-06-18 20:40:05,link,8,77,26,111
18807449704,"Never change, Amy Schumer.",2016-06-16 21:10:00,link,163,72,3,238
10513336322,"""I could not consent to the introduction into our national life of a device so alien to all our traditions as the referendum,"" Clement Attlee said, ""which has only too often been the instrument of Nazism and fascism.""",2016-06-21 07:00:00,link,194,15,23,232
95926963131,2003 Miss North Dakota USA is dead at the age of 37.,2016-06-16 09:12:04,link,20,38,39,97
5281959998,"An under-the-radar museum has become one of the most influential contemporary institutions in the country, if not the world.",2016-06-22 01:55:00,link,21,42,17,80
13652355666,More than 50 officers are conducting the search for the 2-year-old boy.,2016-06-15 02:30:00,link,108,78,49,235
7245371700,Kevin Hart has some explaining to do.,2016-06-22 19:31:53,link,3,53,5,61
18807449704,LeBron James has done what at times seemed impossible.,2016-06-19 22:30:00,link,104,39,8,151
7245371700,Kelly Osbourne made her support for the LGBTQ community permanent.,2016-06-16 10:37:24,link,122,93,43,258
95926963131,The number of young lives lost in the Orlando shooting has been overwhelming.,2016-06-17 15:26:03,link,118,33,43,194
95926963131,Twenty-nine dogs and five cats now have a second chance at life. (via PEOPLE Pets),2016-06-18 21:01:07,link,138,53,45,236
7245371700,"Whoa, that's a lot of dough.",2016-06-18 01:15:28,link,56,43,36,135
86680728811,Marcia Clark explains the domestic violence bias in the O.J. Simpson trial.,2016-06-16 07:23:38,link,163,15,27,205
10513336322,#BREAKING: The Cleveland Cavaliers have beaten the Golden State Warriors in Game 7 to win the NBA championship and end Cleveland's title drought.,2016-06-19 21:46:06,link,52,46,27,125
10513336322,"""We are still an aquatic mammal, I believe. We came out of the water and lots of us can't wait to get back in again.""",2016-06-19 04:40:00,link,20,41,15,76
10606591490,Park officials busted him walking off the designated boardwalk at the Mammoth Hot Springs,2016-06-16 18:41:52,link,200,21,19,240
52150999700,"Roxxxy Andrews, Alyssa Edwards and all the RuPaul's Drag Race stars are amping it UP. 💃🔥",2016-06-17 12:34:00,link,175,12,39,226
13652355666,The death toll is expected to rise.,2016-06-22 16:21:00,link,196,71,31,298
75932763901,OMG! Get the exciting details on Ivanka Trump's Baby No. 4 news (via Closer Weekly) —> http://bit.ly/1ZRnWTv,2016-06-16 03:00:00,photo,25,54,29,108
95926963131,Robert F. Kennedy was allegedly more faithful than any of the other Kennedy men.,2016-06-16 17:57:07,link,27,76,44,147
52150999700,Roland Emmerich has a grand vision for a Stargate reboot. 🙌,2016-06-17 19:23:00,link,122,64,7,193
25902406772,Not where you expect to see Tim Tebow.,2016-06-15 20:08:01,link,140,94,42,276
10606591490,"Channing Tatum: ""I think it's a horrible idea to let someone off because possibly of what they are going to be capable of doing.""",2016-06-23 17:00:29,link,13,95,31,139
75932763901,"TWINS! If you think this photo is cute, wait until you see Coco and Chanel's latest matching outfits! —> http://bit.ly/28MEFqS",2016-06-21 13:00:00,photo,137,46,35,218
18807449704,Life of Dad's #CheerioChallenge is the cutest challenge yet.,2016-06-18 06:00:00,link,98,88,32,218
18807449704,A touching and powerful act of solidarity.,2016-06-21 15:30:00,link,162,38,38,238
13652355666,"""I saw flames and a line of fire hugging the mountains,"" says Sebastian Alonzo, who works nearby. http://usat.ly/28LFO2L",2016-06-21 12:46:00,video,21,96,42,159
86680728811,The Senate could vote as early as today on several measures aimed at keeping firearms out of the hands of suspected terrorists. http://abcn.ws/1UbxrsS,2016-06-16 15:03:19,link,14,20,17,51
25902406772,Russia's track and field team has been banned from this summer's Olympics in Rio de Janeiro.,2016-06-17 10:32:39,link,197,54,12,263
10513336322,"""Anything that goes some way towards us not needing Prince William on the cover of a magazine in a hope to change attitudes – and that includes Prince William on the cover of Attitude magazine – is OK with me.""",2016-06-16 10:20:00,link,99,83,13,195
13652355666,So. Many. F-bombs.,2016-06-23 08:23:00,link,5,99,16,120
75932763901,PLASTIC SURGERY?! Fans are accusing Natalie Portman of getting work done to her face — and when you see the photos you'll understand why —> http://bit.ly/1rtHamc,2016-06-18 02:15:01,photo,139,54,33,226
13652355666,"It was, in short, a mess. An embarrassing mess.",2016-06-19 18:14:08,link,5,78,45,128
18807449704,"The story continues to fill in background details on the state of the galaxy far, far away.",2016-06-22 01:30:00,link,81,54,5,140
25902406772,That ain't right.,2016-06-20 21:40:00,link,198,89,36,323
5281959998,Safety. Family. Home. What LGBT spaces mean to The New York Times readers.,2016-06-18 09:25:00,link,142,43,1,186
13652355666,Many of the protesters wore black to mourn the rape and killing of a local woman in which a former U.S. Marine is a suspect.,2016-06-19 09:29:11,link,56,59,12,127
18807449704,"""Honestly, what did I just watch?""",2016-06-24 07:51:35,link,85,76,14,175
52150999700,Taylor Swift appears to have moved on in a very big way. 😍,2016-06-15 18:20:44,link,100,65,29,194
25902406772,"WOW
WOW
WOW",2016-06-16 22:51:39,photo,140,11,22,173
10513336322,The world's most famous currency speculator has warned that a vote for Britain to leave the EU would trigger a bigger and more damaging fall for sterling than the day he forced Britain out of the Exchange Rate Mechanism almost a quarter of a century ago.,2016-06-21 02:00:00,link,107,63,32,202
112638779551,The Philadelphia 76ers reportedly have told Ben Simmons they will draft him No. 1 overall on Thursday.,2016-06-21 12:17:38,link,112,65,37,214
10513336322,"Ever wondered what language Oompa-Loompas speak, or what the plural of quadropus is, or what rhymes with frobscottle?

The Oxford Roald Dahl Dictionary is here to help you.",2016-06-18 01:00:00,link,51,83,7,141
86680728811,"Hero jumps into river to save unconscious woman who was trapped in sinking SUV. ""I knew if I couldn't get the door open, she would die.""",2016-06-16 06:28:07,link,117,3,31,151
52150999700,Game of Thrones is about to unleash the most SPECTACULAR battle in TV history.,2016-06-17 14:03:21,link,150,32,7,189
52150999700,The famed Led Zeppelin Official song is facing serious copyright charges 45 years later.,2016-06-18 16:36:00,link,77,82,39,198
75932763901,"OMG! She's one of the most famous reality stars on TV, but did you know she's only worth $10,000?! Fans thought she would be worth MILLIONS! –> http://bit.ly/1XV2TAL",2016-06-19 05:45:00,photo,179,27,19,225
52150999700,The pregnant Grey's Anatomy alum is fully on board for her new CBS show!,2016-06-23 15:07:01,link,104,65,33,202
18807449704,Can't unsee. 😂,2016-06-23 14:30:00,link,142,43,7,192
18807449704,Don't mess with Steven Spielberg.,2016-06-19 15:25:00,link,72,28,23,123
10513336322,South Korea's 'space out' competition is in its third year. It promotes a life free from stress and information overload. Contestants spend 90 minutes doing absolutely nothing – under the slogan of Relax Your Brain – a possible antidote to the country's ever increasing screen-hunger,2016-06-23 04:20:00,video,35,93,30,158
7245371700,It matters to see a potential president offering forthright support of reproductive rights and abortion access.,2016-06-22 15:40:13,link,5,8,23,36
5281959998,"Watch corals in their procreative dance, a spectacular event that happens once a year after the full moon.
http://nyti.ms/28Jluym",2016-06-20 12:55:00,video,15,52,15,82
112638779551,This pierogi race turned into a full-fledged wrestling match.,2016-06-23 08:52:35,link,115,18,2,135
95926963131,Rodney Sumter's close friend tells PEOPLE exclusively she's extremely relieved he's still alive.,2016-06-15 14:40:05,link,31,49,24,104
25902406772,Von Miller has a different take on Johnny Manziel.,2016-06-17 13:23:54,link,116,80,47,243
5281959998,"For the fourth time in less than 2 weeks, the police department in Oakland is answering to a different leader.",2016-06-18 16:55:00,link,88,75,4,167
10606591490,"TIME interviews Jeffery Wasserstrom, Chinese history professor at UC Irvine.",2016-06-22 00:06:49,video,12,67,42,121
112638779551,DeMarco Murray is looking to have a bounce-back season with the Tennessee Titans after stumbling with the Philadelphia Eagles.,2016-06-22 22:04:21,link,182,63,17,262
112638779551,"The NHL has a jam-packed centennial season scheduled, including four outdoor games and a Lord Stanley's Cup finals rematch.",2016-06-21 13:49:15,link,173,62,26,261
7245371700,Selena Gomez and Christina Grimmie's friendship went way back.,2016-06-19 12:52:11,link,140,48,49,237
10606591490,Millennials are still burdened with student loans.,2016-06-21 02:30:10,link,109,20,29,158
25902406772,Ezekiel Elliott has potential to be a monster for the Dallas Cowboys.,2016-06-19 12:45:04,link,66,1,40,107
75932763901,CONGRATS!!! She is pregnant with baby No. 3!!! Click here to find out who —> http://bit.ly/28M2iwb,2016-06-22 19:00:01,photo,183,96,11,290
75932763901,We LOOOOVE his name! What do you think?,2016-06-24 14:30:00,link,104,68,11,183
7245371700,I'm getting a 1950s vibe.,2016-06-22 02:33:24,link,78,48,9,135
7245371700,Real World: Seattle set the bar high.,2016-06-15 02:30:29,link,40,26,35,101
86680728811,Congressional Democrats' staging an hour-long sit-in on the House floor to protest inaction on gun violence were not without their creature comforts.,2016-06-23 02:05:52,link,96,3,39,138
10606591490,"""The hardest decision of my life.""",2016-06-17 14:30:29,link,143,24,34,201
5281959998,The next best thing to a trip to Sicily. (via The New York Times Food),2016-06-18 19:55:00,link,38,36,25,99
25902406772,The Pittsburgh Steelers QB Ben Roethlisberger isn't the only one..,2016-06-15 13:59:48,link,136,15,6,157
7245371700,"""In 2016, everyone can benefit from behaving in a better, more loving way.""",2016-06-18 20:58:08,link,39,56,30,125
5281959998,Chicago embraces new energy while staying true to its roots.,2016-06-17 22:55:00,link,1,58,12,71
5281959998,"When asked his name, the man charged with murdering the British lawmaker Jo Cox said, ""My name is death to traitors, freedom for Britain.""",2016-06-18 10:54:00,link,47,81,16,144
75932763901,PREGNANT! Ashton Kutcher and Mila Kunis are expecting baby No. 2! —> http://bit.ly/1XYedOa,2016-06-15 21:53:46,photo,10,32,29,71
112638779551,Here's what NBA players are saying about the Cavaliers' epic comeback in the Finals and LeBron James' MVP performance,2016-06-19 22:29:20,link,91,41,11,143
5281959998,Publisher Ho Pin has a sound strategy for staying out of the clutches of China's police: his address.,2016-06-19 06:25:00,link,132,47,10,189
18807449704,Lonelygirl15 changed the game,2016-06-17 07:30:01,link,161,47,48,256
75932763901,"Kelly Clarkson's baby daughter, River Rose, is growing up SO fast! Wait until you see how big she looks in this new video (via Closer Weekly) —> http://bit.ly/28MbTbg",2016-06-21 23:00:00,photo,31,13,6,50
52150999700,The world better watch out for this former The X Factor singer. 🙌🏻,2016-06-21 20:15:00,link,147,35,46,228
10606591490,This particular case is a nail-biter for a few reasons.,2016-06-23 12:00:23,link,138,61,8,207
25902406772,The Atlanta Braves slugger gives his squad something to cheer about.,2016-06-15 23:26:06,photo,95,6,50,151
13652355666,Everything you ever needed to know about tornadoes,2016-06-23 22:45:01,video,87,81,45,213
13652355666,"Jo Cox was a British lawmaker and 41-year-old mother of two who ""believed in a better world."" http://usat.ly/1Un3RD0",2016-06-17 08:36:25,video,195,74,27,296
95926963131,"We've all been there—smearing on self-tanner or getting a spray tan when, all of a sudden, everything goes horribly wrong.",2016-06-23 00:00:22,link,139,79,37,255
86680728811,"In an attempt to defend his controversial claims, Donald J. Trump tweeted a story from anti-Obama website that cites a newly discovered ""secret"" memo the website says proves Obama is an ISIS supporter:  http://abcn.ws/1Q5jMr0",2016-06-15 14:29:18,link,21,43,29,93
18807449704,This dog has seen some stuff 😂 😂 😂,2016-06-17 05:00:00,link,54,48,40,142
5281959998,A summer comfort hit.,2016-06-20 17:55:00,link,170,17,16,203
10606591490,"""If the girl power moments felt contrived, they were. If the failings of the men blinded by their own pride—the slavers, Theon, Jon and Ramsay—felt obvious, they were.""",2016-06-20 17:00:49,link,118,60,5,183
75932763901,ANOTHER TRANSFORMATION! This is what Teen Mom star Amber Portwood looked like a month ago — but fans think she's gone too far with her newest feature! See it here —> http://bit.ly/28PJxHr,2016-06-24 08:30:01,photo,77,39,17,133
95926963131,Simon Cowell has found his golden buzzer-worthy act.,2016-06-22 07:22:04,link,197,55,46,298
75932763901,GONE TOO FAR?! Khloé Kardashian's latest transformation has fans everywhere totally shocked – and it ISN'T because of weight loss! –> http://bit.ly/1Wg2SX5,2016-06-17 19:30:01,photo,25,30,17,72
10606591490,Ode to Joy never sounded so unhappy.,2016-06-20 08:00:36,link,14,1,47,62
25902406772,There was a lot going on with the Curry family in Game 6.,2016-06-17 10:59:11,link,75,98,50,223
25902406772,Could Dwight Howard be heading to the New York Knicks?,2016-06-23 16:06:38,link,13,81,33,127
75932763901,WOW! This 70-year-old star just flaunted her impressive body in a bathing suit — can you guess who? (via Closer Weekly) —> http://bit.ly/1V1x5EP,2016-06-17 23:30:00,photo,81,64,25,170
112638779551,"""It's your job to stay in the moment. If you don't, your scorecard is to pay."" - Shane Bacon on what makes Oakmont Country Club so difficult.",2016-06-15 08:25:40,link,119,32,47,198
75932763901,PREGNANT! See which star just showed off her HUGE baby bump (via Closer Weekly) —> http://bit.ly/28JVEtG,2016-06-22 05:30:00,photo,158,89,50,297
86680728811,"Two and a half years after Fallujah fell to ISIS, Iraqi counterterrorism forces are pushing deeper into the city to reclaim it from militants.",2016-06-21 05:54:36,link,177,70,26,273
18807449704,Selma Blair reportedly had to be removed on a stretcher and taken to the hospital.,2016-06-21 11:15:01,link,116,35,8,159
18807449704,Personal assistant to Bran Stark 😮,2016-06-15 06:49:48,link,160,78,31,269
18807449704,Whoa,2016-06-16 05:54:26,link,94,43,29,166
18807449704,Taylor Swift and Tom Hiddleston are back!,2016-06-22 13:30:01,link,21,30,31,82
112638779551,Moving day at the U.S. Open Championship.,2016-06-18 17:54:58,video,95,72,20,187
13652355666,A trash drop-off for the ages.,2016-06-22 06:40:00,link,115,97,5,217
7245371700,And their career choices aren't so ~out of the box~.,2016-06-23 17:20:12,link,94,40,47,181
112638779551,"This. is. AWESOME. We could watch these trampoline tricks all day. 

Kristen Balboni for @TheBuzzer",2016-06-15 17:37:46,video,120,89,23,232
52150999700,The upcoming Justice League is officially one complete story. 👊🏼,2016-06-21 11:21:00,link,187,96,40,323
10513336322,"Naga Munchetty: ""I remember my mum driving me to a party one day when I was 15 and when we got to the block of flats we saw two of my schoolmates sitting on a bench drinking cider, and she said: 'That's it! I'm taking you home.' And she did.""",2016-06-18 03:40:00,link,170,62,9,241
112638779551,How did LeBron James' first dunk go down? #Betcha,2016-06-16 15:39:51,video,121,88,33,242
112638779551,Losing a starter in the NBA Finals is usually a deathblow. That doesn't appear to be the case for the Golden State Warriors. Dieter Kurtenbach explains:,2016-06-15 15:01:10,link,21,41,41,103
7245371700,Loving this rap-rock remix.,2016-06-23 22:24:04,link,111,38,42,191
112638779551,"#CarlEdwards slams into the back of teammate Ricky Stenhouse, Jr. ... but it's cool. @TheBuzzer's Daryl Motte remembers on #NASCAR #TBT.",2016-06-16 09:31:06,video,71,38,2,111
95926963131,"""We need to learn to love again,"" Christina Aguilera writes. ❤️",2016-06-16 23:18:43,link,181,18,10,209
10513336322,Guardian journalist Patrick Kingsley witnessed a moving rescue from a leaking rubber boat just off Libya this week. Watch him take part in an interview about the event LIVE from Sicily,2016-06-16 06:03:12,video,163,71,26,260
7245371700,Things get weird when you talk to a dead person.,2016-06-17 19:19:05,link,75,58,29,162
86680728811,Campaigners in England are making one last push with voters before tomorrow's groundbreaking referendum on whether the country should stay in the European Union.,2016-06-22 18:15:53,link,14,43,43,100
7245371700,Benicio del Toro should probably hire a new PR rep + The media should probably stop talking about Meg Ryan's face right now.,2016-06-16 14:41:03,link,42,40,25,107
13652355666,The owner believes someone purposely let the dogs out of their crates.,2016-06-21 00:55:00,link,84,28,24,136
112638779551,"""We will do our best to follow your lead until we meet again."" -- Murray Howe eulogizes his father, Detroit Red Wings legend Gordie Howe",2016-06-16 11:09:45,video,29,81,8,118
25902406772,oh boy,2016-06-15 18:40:14,link,55,48,49,152
52150999700,Things got a little awkward on the Ghostbusters set. 😂,2016-06-18 11:33:00,link,151,34,6,191
86680728811,"NEW: Chelsea Clinton and husband Marc Mezvinsky welcome second child, Aidan. http://abcn.ws/1UfwYWG",2016-06-18 10:56:51,photo,130,19,15,164
10606591490,Putin said his previous comments on Trump were misinterpreted,2016-06-18 11:30:27,link,60,85,42,187
18807449704,NOM!,2016-06-16 19:16:10,link,184,69,37,290
18807449704,Siri has some ideas about Game of Thrones too.,2016-06-23 17:48:39,link,58,83,10,151
18807449704,The Westboro Baptist Church is considered an extremist group by the Southern Poverty Law Center.,2016-06-19 09:53:47,link,78,83,14,175
112638779551,Team USA's roster for this year's Summer Games is taking shape.,2016-06-23 12:45:08,link,81,9,20,110
5281959998,Donald J. Trump's aides are scrambling to raise money to compete against Hillary Clinton's cash juggernaut.,2016-06-16 23:55:00,link,68,62,38,168
52150999700,You read it right–Tears for Fears is bringing the '80s BACK. 🔥,2016-06-17 00:40:00,link,111,4,44,159
10606591490,Weird.,2016-06-17 08:00:05,link,14,71,11,96
75932763901,"Just one month after confirming their split, Teen Mom 2 star Kailyn Lowry makes the announcement NO ONE saw coming — read it here: http://bit.ly/28JjAZZ",2016-06-20 11:30:00,photo,180,13,12,205
13652355666,"It's official. The ""Brexit"" is happening. The United Kingdom voted to leave the European Union. Here is what to expect next.",2016-06-24 00:15:55,video,72,66,36,174
13652355666,Shake up your summer this year.,2016-06-19 19:48:00,link,26,8,9,43
5281959998,"When a photographer learned his father's life was about to end, his own life changed. ""And it did so — hard to believe sometimes — for the better,"" he writes. http://nyti.ms/1PslX2c

Photo: Clarence Williams",2016-06-15 00:55:00,photo,97,97,13,207
112638779551,2016 NBA Mock Draft http://foxs.pt/28Qhnzw,2016-06-22 11:38:11,video,96,50,7,153
75932763901,"Just one month after the cheating rumors started, Sharon and Ozzy Osbourne's relationship just took another CRAZY turn!!! —> http://bit.ly/1UfvwUa",2016-06-18 22:30:00,photo,83,55,3,141
13652355666,"""Recovery will never be easy, but we're tight-knit ... We support each other.""",2016-06-15 00:50:00,link,121,49,45,215
5281959998,"Questions of a Saudi connection to 9/11 have risen anew with calls to release a classified section of a congressional report — the so-called 28 pages, whose secrecy has made them almost mythical.",2016-06-17 21:27:16,link,120,9,9,138
75932763901,CHEATER! The truth FINALLY comes out about Taylor Swift and Calvin Harris's relationship —> http://bit.ly/1UAh50H,2016-06-17 10:35:00,photo,28,92,21,141
5281959998,Most people on the terrorist watchlist who attempt to buy guns are approved.,2016-06-15 13:55:00,link,158,7,20,185
112638779551,Daniel Cormier reveals a couple of text messages he shared with Brock Lesnar after he was added to UFC 200.,2016-06-15 12:42:49,link,92,75,33,200
95926963131,"John Legend, Bernie Sanders, and Bette Midler were among the many to express their disgust at the Senate.",2016-06-20 20:58:06,link,29,11,40,80
112638779551,"Step right up and take a selfie with this LeBron James ""dryer lint sculpture.""",2016-06-22 09:56:52,link,96,63,28,187
5281959998,"Exercise caused mice to pump out a protein that scientists sometimes refer to as ""Miracle-Gro"" for the brain.",2016-06-15 11:25:00,link,126,58,44,228
75932763901,"Kate Middleton's diet, revealed! You won't believe how the princess keeps her perfect figure (via Closer Weekly) —> http://bit.ly/24WkyYX",2016-06-17 22:30:00,photo,155,52,50,257
95926963131,"The older Apple Martin gets, the more she's turning into mother Gwyneth Paltrow's mini-me. (via People Babies)",2016-06-22 16:11:06,link,102,41,20,163
86680728811,"NEW: Federal authorities have recovered video from security cameras inside Orlando's Pulse nightclub that shows the shooter firing his assault rifle and systematically killing innocent victims, sources tell ABC News. http://abcn.ws/1Qcdm9F",2016-06-17 17:54:10,link,9,49,34,92
52150999700,Meat Loaf's announcement comes less than a week after he collapsed mid-concert.,2016-06-22 17:16:00,link,126,95,33,254
18807449704,Sansa's revenge gave Game of Thrones fans something to believe in.,2016-06-21 00:50:00,link,157,12,17,186
18807449704,"Meanwhile, other companies have cut back (or cut completely) their support for the GOP convention.",2016-06-19 10:20:01,link,12,47,50,109
95926963131,Melissa McCarthy and Kristen Wiig just got us even more excited for the Ghostbusters reboot. 😂,2016-06-18 09:20:05,link,130,67,11,208
5281959998,"When ignorance and power join forces, history itself can be erased.

(via The New York Times Opinion Section)",2016-06-21 03:25:00,link,82,80,16,178
86680728811,"Stray kitten crashes a reporter's live shot, seizing the purr-fect opportunity to steal the show. http://abcn.ws/28L2RsY",2016-06-20 16:34:02,video,195,80,41,316
95926963131,The Olympic gold medalist diver opens up about being diagnosed with HIV at age 28.,2016-06-23 08:24:07,link,171,44,32,247
7245371700,"Memes are taking over the world, tbh.",2016-06-15 03:42:30,link,63,31,49,143
5281959998,"""I look over, and he shoots the girl next to me,"" said Angel Colon, who was shot several times during the Orlando attack.",2016-06-17 06:55:00,link,188,77,35,300
112638779551,Philadelphia 76ers icon Allen Iverson sent Ben Simmons a message after the team made him the No. 1 pick.,2016-06-23 23:57:12,link,73,47,26,146
112638779551,No team had ever come back from 3-1 down. The Cleveland Curse was poised to claim another. Then LeBron James happened:,2016-06-20 00:55:12,link,147,10,42,199
5281959998,"""Essentially, we  believe if you are too dangerous to fly on an airplane, you are too dangerous to buy a gun,"" one senator said.",2016-06-22 08:55:01,link,189,62,14,265
5281959998,"The buttermilk tenderizes and lets the pepper, rosemary, and garlic do their thing.",2016-06-16 16:55:00,link,174,9,46,229
18807449704,A new friendship was born on Game of Thrones.,2016-06-20 21:10:01,link,73,70,48,191
52150999700,"Harry Potter fans, rejoice! J.K. Rowling is releasing an AWESOME new version of #FantasticBeasts. ✨",2016-06-21 11:00:00,link,159,91,28,278
52150999700,"George R.R. Martin is amazed by how fast Stephen King writes, Game of Thrones fans! 😂",2016-06-23 12:18:21,link,135,99,2,236
95926963131,"Rest in peace, Christina Grimmie.",2016-06-17 11:46:07,link,159,3,47,209
52150999700,Tyler Hoechlin is set to take on the iconic Superman role! 👊🏼,2016-06-19 17:01:00,link,109,80,43,232
52150999700,Kelly Osbourne's tribute to the Orlando shooting victims may be the most unique yet.,2016-06-15 11:32:00,link,76,73,47,196
75932763901,BEAUTIFUL! This little angel looks just like her gorgeous mama! — And she's already chatting up a storm --> http://bit.ly/1thUhYW,2016-06-20 15:00:00,photo,90,61,49,200
7245371700,Selena Gomez's character has no chill.,2016-06-19 08:27:08,link,59,4,2,65
112638779551,Two professional sports were altered when perhaps the greatest athlete of his generation picked the Royals over the Buccaneers.,2016-06-21 14:52:29,link,119,68,40,227
112638779551,"WWE is in Las Vegas for their Money in the Bank pay-per-view. 

Here's a full breakdown of the card and a prediction for each match. 

Who do you think is going to win the briefcase?!",2016-06-19 15:56:04,link,113,82,30,225
52150999700,"It's never too late to watch Goodfellas, even if it's 25 years later.",2016-06-19 09:49:11,link,8,51,8,67
10606591490,3. Know what drains you and what sustains you.,2016-06-18 05:00:46,link,20,39,34,93
10513336322,"""I had it easier than a lot of the men who weren't out of the closet, weren't supported by friends and family like me, and who were at other bathhouses where there was a lot more violence."" 

Widely perceived as a deliberate attempt by police to silence gay activism in Toronto, the raids instead galvanized the gay community and its allies.",2016-06-22 15:00:00,link,94,13,29,136
25902406772,Sam Presti seems pretty confident about Kevin Durant being a free agent.,2016-06-18 21:44:39,link,53,44,29,126
86680728811,"The White House is calling the ruling in favor of net neutrality a ""victory for the open, fair and free Internet as we know it today.""",2016-06-15 03:31:00,link,115,100,40,255
25902406772,Toronto Blue Jays slugger Michael Saunders was SOOOO close.,2016-06-17 23:10:58,link,187,53,21,261
75932763901,"Vin Diesel's latest picture of his daughter, Pauline, will bring a tear to your eye. And when you see the whole thing, you'll understand why —>http://bit.ly/21kz3F9",2016-06-18 12:00:00,photo,150,83,29,262
18807449704,Maybe these Donald J. Trump quotes aren't the best parenting advice ever...,2016-06-17 14:20:44,link,189,22,24,235
86680728811,"Orlando shooter exchanged text messages with his wife during the attack, sources briefed on the investigation tell ABC News. http://abcn.ws/1W3kvKy",2016-06-17 08:36:29,link,15,32,15,62
25902406772,This is a HUGE compliment to LeBron James.,2016-06-21 08:53:03,link,110,76,39,225
112638779551,Will Phil Mickelson ever complete the career Grand Slam? He's experienced a lot of heartbreak at the U.S. Open Championship. #USOpen,2016-06-17 18:27:06,video,56,65,36,157
18807449704,This kitten walks with the help of a 3D prosthetic leg.,2016-06-20 23:50:00,video,24,10,17,51
25902406772,Bulls bros 4 ever,2016-06-22 21:13:04,link,95,99,41,235
112638779551,"A bunch of Irish fans stopped being rowdy for a few minutes to sing a lullaby to a baby.

Rachel Bonnetta for @TheBuzzer.",2016-06-22 20:04:07,video,111,13,10,134
25902406772,Glen Gulutzan gets another shot as head coach.,2016-06-17 09:38:23,link,76,73,4,153
7245371700,"Way, way, more.",2016-06-16 18:25:55,link,113,74,14,201
112638779551,Greg Olsen is auctioning off his classic Camaro to help kids with heart issues.,2016-06-23 14:15:06,link,56,32,42,130
7245371700,These songs fit these powerful Orange Is the New Black scenes perfectly.,2016-06-17 14:58:19,link,41,45,14,100
10606591490,7. They're afraid to spend.,2016-06-23 03:30:12,link,85,43,46,174
112638779551,"Table tennis will be part of the 2016 Summer Olympics, and this shot is worth of a gold medal.",2016-06-21 14:16:30,link,42,13,11,66
86680728811,Four men charged with criminal trespassing after interrupting Pastor Joel Osteen's sermon last year walked out of court singing in victory after being cleared of all charges.,2016-06-22 23:54:05,link,126,87,4,217
95926963131,"In honor of Father's Day, we have an important poll. 😍 (via PeopleStyle)",2016-06-19 20:40:04,link,34,63,35,132
10606591490,It's a pretty magical clip.,2016-06-21 07:00:11,link,73,14,45,132
10513336322,"""Yoga saved me from nights of sleeplessness after an illness.""",2016-06-22 12:30:00,link,27,31,13,71
25902406772,"Come on man, the Golden State Warriors lost.",2016-06-23 12:19:03,link,187,6,3,196
18807449704,Glasses can put a burden on your daily life.,2016-06-15 03:00:00,link,188,100,37,325
112638779551,Seattle Mariners slugger Dae-Ho Lee smashed a TV camera with a line drive on Thursday night.,2016-06-17 09:30:43,link,114,40,10,164
7245371700,"When life gives Beyoncé lemons, she wears them as a headband.",2016-06-23 05:53:16,link,29,73,23,125
10606591490,"""The Taliban are killing our children, and our government is giving money to their sympathizers.""",2016-06-23 04:00:21,link,20,97,44,161
52150999700,J. J. Abrams penned a heartfelt tribute to the late Star Trek actor.,2016-06-19 16:34:05,link,87,17,7,111
52150999700,The legendary Steven Tyler is getting REAL honest about his next music adventure.,2016-06-23 20:04:00,link,141,64,24,229
86680728811,"2-year-old boy diagnosed with progressive hearing loss does his ""happy dance"" after hearing his mom through hearing aids for the first time. http://abcn.ws/1UEkUOu",2016-06-17 14:42:57,video,80,84,50,214
95926963131,A neighbor is opening up about the time she was on her way home and saw something she simply couldn't ignore. (via People True Crime),2016-06-21 16:03:22,link,36,11,43,90
25902406772,Bet you've never seen a dude chip a golf ball to himself and then shoot it like MJ into the cup.,2016-06-15 14:36:31,link,115,9,38,162
5281959998,"While you're watching Germany on the field during UEFA EURO 2016, see in real time its chances of advancing to the next round.",2016-06-21 10:15:00,link,53,12,37,102
112638779551,Will it ever get bad enough at Baylor Athletics for this drastic step?,2016-06-16 10:35:33,link,192,12,9,213
7245371700,This massacre has left us angry and afraid. Here's what you can do to help.,2016-06-19 06:42:25,link,46,63,3,112
5281959998,"""After speaking with those closest to me, I've come to realize that my health, and my family's health, comes before anything else,"" Rory McIlroy said.",2016-06-22 06:55:07,link,167,48,8,223
86680728811,Honda is recalling 1 million sedans and SUVs in China to replace potentially faulty Takata airbags. http://abcn.ws/1XZmNMu,2016-06-17 12:07:00,link,60,17,8,85
112638779551,The Charleston RiverDogs Director of Fun knows how to have a good time.,2016-06-15 06:47:00,link,69,1,18,88
10606591490,These moves are safer for your lower back.,2016-06-20 00:30:13,link,155,90,33,278
52150999700,The Person of Interest series finale was an emotional rollercoaster. 😓,2016-06-21 22:12:24,link,85,59,39,183
10513336322,"""I am a migrant from the European Union. You have probably heard lots of things about people like me in the referendum campaign, but you may not have actually heard from any of us. We have got more to lose than anyone else – our livelihoods depend on the outcome – but we do not have a voice, or a vote.""",2016-06-22 02:20:00,link,34,92,18,144
7245371700,Probably the weirdest Game of Thrones hangout session ever.,2016-06-19 16:20:55,link,14,19,38,71
10606591490,Beyoncé fans rejoice.,2016-06-22 13:30:12,link,90,7,9,106
112638779551,#LeBron is the King. The #Warriors and their 73 wins ended up being his jesters.,2016-06-20 10:47:38,link,104,89,18,211
10606591490,"In calls to police, the shooter was described as ""calm"" and ""deliberate.""",2016-06-20 12:00:55,link,67,1,39,107
10606591490,3. Prep your intro lines.,2016-06-19 17:30:08,link,132,91,1,224
86680728811,"Texas man arrested in the death of his infant daughter, whom he left in a hot car for 4 hours. He then placed her in his refrigerator and attempted to perform CPR on her.",2016-06-22 18:46:34,link,55,52,35,142
7245371700,"""Bananas as f***."" - Band of Horses on their indie rock dream team of collaborators on their latest album. 

They also talk making the same song five times and the one song that was eight years in the making.",2016-06-18 16:01:13,link,137,80,3,220
52150999700,Rufus Wainwright has spoken out about the effects of the #Orlando shooting.,2016-06-18 14:51:00,link,183,13,39,235
5281959998,"There's much for Hillary Clinton to consider in a vice-presidential pick: competence, agreement on policy, geography, chemistry: ""It can't be an arranged marriage with someone she meshes well with on paper.""",2016-06-20 06:25:01,link,72,72,17,161
7245371700,"We need answers, Disney.",2016-06-16 23:49:52,link,129,77,39,245
13652355666,Beat the crowds.,2016-06-18 17:17:00,link,182,52,45,279
25902406772,Now this is a goal.,2016-06-15 09:39:27,link,134,65,4,203
5281959998,Meet the woman who introduced Tina Fey to Amy Poehler.,2016-06-15 15:25:00,link,34,33,17,84
95926963131,Orange Is the New Black star Adrienne C. Moore has details on the changes that are coming to the prison in this new season! (via People Video),2016-06-21 09:19:00,video,68,85,44,197
13652355666,ISIL has redoubled its efforts to encourage lone wolf attacks.,2016-06-16 12:12:00,link,151,53,39,243
75932763901,ROYAL BABY NEWS! Get the exciting details (via Closer Weekly) —> http://bit.ly/1Vzibuk,2016-06-19 22:45:00,photo,142,70,24,236
25902406772,Tiger Woods is proud of Dustin Johnson.,2016-06-19 20:21:34,link,26,98,4,128
112638779551,"Who wins between Robbie Lawler and Tyron ""The Chosen One"" Woodley? Hear what Rory MacDonald and Stephen Wonderboy Thompson have to say",2016-06-17 15:56:41,link,119,64,31,214
112638779551,"A few hundred Irish fans serenaded a woman in the streets at the 2016 UEFA EURO, and it was hilarious.

Nicole Dabeau for @TheBuzzer.",2016-06-19 12:21:30,video,131,28,11,170
10513336322,"""This is not the equivalent of 1914 or 1939. It is closer to 1815 and Waterloo. A Britain that votes to stay with the EU would be able, for a crucial while, to wield serious clout, in Europe's interest and its own. At the start of this campaign I wanted to leave, renegotiate and stay. Now I am for stay, lobby and see what happens next. Whatever anyone says, there is always another time.""",2016-06-16 03:20:00,link,173,27,35,235
112638779551,"For the Stingley family, football remains a tradition following in the steps of the late New England Patriots wideout Darryl Stingley.",2016-06-19 03:51:32,link,191,26,23,240
112638779551,"It'll be an especially tough road for the USC Trojans, Ohio State Buckeyes and many more.",2016-06-21 10:52:43,link,171,94,39,304
5281959998,Michael Jordan and LeBron James are finally and forever connected by a historic cause.,2016-06-21 07:55:00,link,44,36,4,84
7245371700,It's pay day in Westeros.,2016-06-22 16:38:53,link,200,82,34,316
10606591490,"""No one should be bullied for their sexuality or any other reason.""",2016-06-15 15:30:11,link,179,67,27,273
52150999700,Discovery's Shark Week is going to be FIN-tastic this year. 🙌💦,2016-06-23 13:26:00,link,187,33,13,233
52150999700,We're talking live with the adorable Sophia Grace about her new music!,2016-06-22 10:26:10,video,20,35,40,95
112638779551,"Smart move, RNC.",2016-06-17 00:32:17,link,110,41,33,184
112638779551,The Cleveland Cavaliers homepage has been Crying Jordan'd & now no one is safe.,2016-06-15 16:21:40,link,126,46,5,177
7245371700,He's being held without bail.,2016-06-20 21:12:33,link,118,80,50,248
25902406772,Missing the playoffs 3 straight seasons will have ANYONE on the heat seat.,2016-06-22 12:29:35,link,58,48,34,140
13652355666,The hottest ticket in town is also the hottest scam in town.,2016-06-15 20:10:00,link,177,53,21,251
18807449704,'The Battle of the Bastards' on Game of Thrones was one of the best military history lessons you'll ever get.,2016-06-20 22:14:45,link,16,57,37,110
25902406772,Serena Williams looks to defend her 2015 Wimbledon title.,2016-06-22 12:44:41,link,145,40,16,201
25902406772,The UFC has drug tested Brock Lesnar A LOT.,2016-06-21 10:54:42,link,57,39,43,139
112638779551,"Brock Lesnar explains exactly what will happen to Mark ""Super Samoan"" Hunt when they fight at UFC 200.",2016-06-16 12:24:19,link,70,89,6,165
112638779551,ABC had its best-ever audience for an NBA broadcast Sunday night.,2016-06-20 11:40:54,link,96,20,22,138
86680728811,Newborn baby photographed with motorcycle gear has touched the heart of the internet because of the heartbreaking story behind the photo.,2016-06-16 04:30:06,link,198,37,16,251
95926963131,"Father-of-five Joey Rott is opening up about his emotional first Father's Day as a single parent—since the unexpected death of his wife, Casi.",2016-06-20 18:47:25,video,119,76,9,204
112638779551,"Stephen Curry, Russell Westbrook and James Harden have all said they will skip the Rio Olympics. LeBron James might too.

But finally on Monday, we discovered that at least one superstar plans to be in Brazil this summer...",2016-06-20 20:02:49,link,40,96,41,177
75932763901,"OMG! Chrissy Teigen's Splash Mountain photo might be the best one we've seen, but the caption will SHOCK you!! (via Life & Style Weekly) —> http://bit.ly/1tvzRfi",2016-06-19 19:45:00,photo,90,38,41,169
112638779551,High quality Beef!,2016-06-18 16:35:03,video,62,21,4,87
86680728811,"The shark was ""probably eating smaller fish when it mistakenly bit into her leg,"" Galveston Island Beach Patrol said. http://abcn.ws/1YvacPE",2016-06-16 14:37:57,link,146,66,22,234
10513336322,"""It's the last day of a campaign that feels long and bitter, the final stretch of a debate that has been brewing in this country for decades. There are two camps whose positions are fixed. Yet in the middle stands a group of people, 10% or more of the electorate, who are still undecided. If you are one of them, here are five closing arguments for what, both sides agree, is almost certainly the biggest political decision of our lifetimes.""",2016-06-22 06:40:00,link,136,18,42,196
95926963131,"You have to see the other summer treats Starbucks is debuting—believe it or not, it gets better. 😍  (via People Great Ideas)",2016-06-15 06:00:22,link,117,89,27,233
10513336322,"At least eight local authorities cancelled or promised to review contracts with a law firm that specialises in fighting support claims for children with special educational needs, after its managing director published a series of tweets apparently gloating at parents.",2016-06-15 02:20:00,link,168,84,2,254
95926963131,This man (or should we say Disney princess) is basically a magician with makeup. 👏 (via HelloGiggles),2016-06-21 02:00:38,link,1,2,35,38
75932763901,"After eight years of marriage, this celebrity couple is calling it quits because of HIS affair! (via Life & Style Weekly) —> http://bit.ly/1PtN116",2016-06-15 11:30:00,photo,153,93,41,287
10513336322,"""He makes false and malicious statements about public and private people. I regard him as semi-hysterical, self-righteous, and utterly unfit to be president of the United States.""",2016-06-18 11:00:00,link,194,66,25,285
7245371700,"""It was Latin night at Pulse. Trump endorsers Marco Rubio and Mitch McConnell did not make the connection that the names of the dead could be confused for a roll call of the families Trump wants to deport.""",2016-06-15 00:09:15,link,181,3,36,220
52150999700,The FRIENDS (TV Show) theme song is one of the most iconic of ALL time. (via HelloGiggles),2016-06-22 04:21:00,link,89,10,4,103
52150999700,Supergirl casts Teen Wolf star Tyler Hoechlin as Superman: http://share.ew.com/DOh9LdO,2016-06-17 05:26:00,video,53,14,46,113
10513336322,"""Western visitors to Egypt are often struck by the sight of men – even soldiers in uniform – holding hands in the street. In Lebanon, you'll find straight men who spend hours preening themselves and, in Afghanistan, warriors who wear eye makeup.

It doesn't mean what you might think it means, but it's also less surprising than it might seem.""",2016-06-22 09:40:00,link,57,28,14,99
25902406772,Andy Dalton = Tom Brady or nah?,2016-06-15 16:39:47,link,58,80,33,171
86680728811,"Former President Bill Clinton and Hillary Clinton said they were ""over the moon"" about the birth of their second grandchild. http://abcn.ws/1Y1blQr",2016-06-18 13:06:22,link,23,94,30,147
112638779551,The unpredictability of the NBA's MVP is creating a predictable uneasiness for the Golden State Warriors ahead of Game 6. Dieter Kurtenbach breaks it down:,2016-06-16 07:18:01,link,3,51,45,99
18807449704,This is the mother of all Krispy Kreme Doughnuts,2016-06-16 05:05:06,link,195,7,23,225
10513336322,"The world eventually caught up to The West Wing, and the show presaged many of the changes that we would see in just a few years time.",2016-06-22 16:00:22,link,21,57,46,124
25902406772,Kevin Durant saw much of The Dark Knight in LeBron James.,2016-06-20 21:41:32,link,59,37,11,107
18807449704,GAME. CHANGER. 😂,2016-06-16 18:46:19,link,103,59,14,176
75932763901,"After posting this video on the internet holding a gun, this reality star had the cops called on her! –> http://bit.ly/1qc9NEj",2016-06-19 14:15:00,photo,75,40,42,157
10513336322,"""Rather than spending £175m on installing two gargantuan copper-nickel plant pots in the middle of the river, in a public-private business model that could burden the taxpayer for years to come, we could simply plant some trees on a bridge that already exists.""",2016-06-17 01:40:01,link,116,78,30,224
95926963131,An Iowa community is mourning the loss of a 4-year-old boy who fatally shot himself.,2016-06-21 11:53:05,link,78,21,19,118
10606591490,10. The race is long and with yourself.,2016-06-15 05:00:32,link,148,97,48,293
10513336322,"Diabetes affects four million people in the UK, and more are diagnosed each year. But what is it and how is technology revolutionising the lives of those who have it?",2016-06-19 11:40:00,link,146,20,22,188
18807449704,So lovely. 💕 💕,2016-06-19 08:00:00,link,176,30,1,207
18807449704,This girl is the future of comedy.,2016-06-19 16:25:25,link,51,55,9,115
25902406772,The date is set for CM Punk.,2016-06-23 09:16:33,link,132,81,21,234
10606591490,"""Don't just listen; emulate.""",2016-06-22 22:00:47,link,170,90,33,293
5281959998,Cleveland and Philadelphia are preparing for the possibility that anger may spill into the streets during the conventions.,2016-06-23 04:55:00,link,133,17,29,179
18807449704,OUCH. OUCH. 😞,2016-06-15 23:00:00,link,1,65,40,106
25902406772,Stephen Curry's wife started a nice little storm.,2016-06-17 23:50:35,video,156,18,18,192
86680728811,"Contradicting statements by presumptive Republican nominee Donald J. Trump, the NRA's top lobbyist tells This Week that patrons of the Orlando nightclub should not have been armed: http://abcn.ws/1Y2HqHC",2016-06-19 11:29:18,link,184,37,1,222
75932763901,"FAMILY PHOTO! For the first time ever, Kristin Cavallari shares a photo of ALL three of her children together — and they are unbelievably adorable! —> http://bit.ly/266hPyw",2016-06-16 17:30:00,photo,95,2,25,122
10606591490,She also shared her nicknames for her children.,2016-06-17 12:00:18,link,30,10,23,63
5281959998,87% of Venezuelans say they do not have money to buy enough food.,2016-06-19 11:55:00,link,43,51,35,129
7245371700,Camila and Tony have sooooo much potential.,2016-06-16 08:49:30,link,167,35,39,241
75932763901,Sad news for Uma Thurman. Get the devastating details (via Closer Weekly) —> http://bit.ly/28R4BBa,2016-06-22 23:30:00,photo,91,52,37,180
112638779551,#Betcha didn't know Alan Shepard once played some golf that was out of this world… literally.,2016-06-15 16:36:45,video,17,51,39,107
10513336322,"Chrome is certainly the most popular browser, but it's a beast that can slow your computer to a crawl if left unchecked.",2016-06-21 08:20:00,link,86,74,13,173
18807449704,HEART CANNOT HANDLE,2016-06-15 04:00:01,link,178,68,32,278
75932763901,She popped!,2016-06-23 13:00:01,link,195,53,6,254
18807449704,"Lesson learned: if you gossip, Justin Bieber will try to shut down your website.",2016-06-15 13:00:00,link,192,33,19,244
112638779551,Porsche gets a surprise win in the closing minutes of the 24 Hours of Le Mans.,2016-06-19 08:19:41,link,108,98,25,231
25902406772,"Thon Maker, in surprising fashion, will be heading to the Milwaukee Bucks.",2016-06-23 20:13:20,link,153,35,24,212
95926963131,A longtime friend of O.J. Simpson believes he will eventually confess to murdering ex-wife Nicole Brown Simpson.,2016-06-16 15:05:09,link,182,23,10,215
10606591490,Was your name a trendsetter?,2016-06-24 05:30:22,link,40,26,15,81
112638779551,Tampa Bay Rays paid tribute to the victims of the Orlando shooting and the LGBT community,2016-06-17 23:49:36,link,113,71,26,210
86680728811,"In the wake of this weekend's mass shooting at a gay club in Orlando, Donald J. Trump says he will meet with the National Rifle Association to discuss how individuals on the nation's terror watch list get access to guns. http://abcn.ws/1rq6cTo",2016-06-15 11:43:57,link,8,10,45,63
112638779551,"Dustin Johnson won the U.S. Open despite a controversial penalty, and he closed the tournament in style",2016-06-19 19:32:07,link,21,53,13,87
75932763901,"SHE'S DONE! With her due date just months away, Blac Chyna just made an announcement that NO ONE saw coming! —> http://bit.ly/1spj11x",2016-06-22 01:30:01,photo,134,25,33,192
112638779551,"Odell Beckham Jr times his swing perfectly and crushes this softball! 

Andy Nesbitt for @TheBuzzer",2016-06-21 13:46:03,video,41,87,25,153
5281959998,"If it sounds familiar that a gunman in a mass shooting would have a history of domestic violence, it should.",2016-06-15 07:55:00,link,16,81,25,122
10513336322,"""Like for many of us, who I am seems to be a contradiction, but only because of prejudices unresolved in our society. Learning that we can change those prejudices, rather than forcing ourselves to hide and live with them, saved me from accepting the things that have caused my pain.""",2016-06-20 06:00:00,link,143,38,49,230
7245371700,Nick Jonas does it all.,2016-06-19 00:32:12,link,160,84,40,284
10513336322,"""Cristiano Ronaldo reacted to a restorative night for the game with all the petulance and pettiness of a spoilt child. Even in a tiny nation's finest hour in football, Ronaldo demands the limelight and so it is gratifying the prima donna was partly responsible for Iceland producing a performance to remember.""",2016-06-15 01:20:00,link,103,64,25,192
52150999700,J.K. Rowling has some VERY harsh words for Donald J. Trump.,2016-06-20 14:56:00,link,39,66,16,121
25902406772,"Wyd? 
""Nun... Chillin""",2016-06-20 14:31:04,link,158,13,48,219
10513336322,"""If anyone doubts that society remains run by and for men, the quiet story of fathers being allowed to get away with refusal to pay for their children should be evidence enough.""",2016-06-17 02:00:01,link,79,63,24,166
52150999700,Ian McKellen's words are seriously touching especially in light of the Orlando tragedy. 🙏👏,2016-06-16 17:23:00,link,26,91,17,134
86680728811,"The FBI says there wasn't enough information to conduct a ""meaningful investigative follow up"" on an individual employees of a Florida gun store deemed ""suspicious""—one they later believe to be Orlando nightclub shooter Omar Mateen: http://abcn.ws/1UCQv72",2016-06-18 20:29:27,link,97,17,46,160
10513336322,"""Europe cannot stand alone without you.""",2016-06-23 07:59:02,link,54,17,12,83
25902406772,Brandon Belt had a pretty good sense of humor after being struck out by a catcher.,2016-06-21 23:42:00,link,181,51,50,282
75932763901,"PLASTIC SURGERY?! When you see the ""after"" photo, you'll understand why some people think the Real Housewives of Atlanta star went under the knife... (via Life & Style Weekly) —> http://bit.ly/2612zXb",2016-06-17 04:45:00,photo,25,93,2,120
5281959998,"Whole grains are good, whether served whole or ground up, experts say, but with a few caveats. (via The New York Times - Well - Health)",2016-06-19 04:25:00,link,31,32,21,84
13652355666,A personal trainer is going to the mat against Sylvester Stallone.,2016-06-24 02:30:00,link,32,48,35,115
52150999700,Yeezy fans mark your calendars. 🙌🏼,2016-06-22 22:33:00,link,188,42,28,258
25902406772,It's celebration time for Pittsburgh Penguins fans!,2016-06-15 10:06:35,link,78,51,39,168
10606591490,"""Supporting other women helps each other, helps women as a group, and also helps the woman that does it.""",2016-06-23 15:00:43,link,54,72,23,149
10606591490,"Feast your eyes, Game of Thrones fans.",2016-06-15 18:00:13,link,81,33,2,116
10513336322,Going to Glastonbury? Read this.,2016-06-20 03:50:00,link,174,47,32,253
25902406772,Malik Beasley isn't afraid of failure. The NBA hopeful and American Family Insurance are proud to #DreamFearlessly.,2016-06-22 20:30:00,video,16,30,4,50
86680728811,"In 120 degree temperatures, some airplanes might not take off, and power grids strain as the outside air keeps transmission lines from cooling.",2016-06-19 07:25:03,link,100,10,49,159
112638779551,Paul Lawrie's ball somehow landed in a fan's tucked-in shirt.,2016-06-23 15:36:02,link,64,47,20,131
7245371700,Pretty Little Liars just revealed Hanna's fate in the shocking Season 7 premiere.,2016-06-21 22:14:10,link,139,83,37,259
75932763901,THINNER THAN EVER! Wait until you see Oprah now after her drastic weight loss (via Closer Weekly) —> http://bit.ly/1UbfpXP,2016-06-16 15:30:00,photo,69,57,30,156
7245371700,The only important thing about political correctness is how it's used — not what we call it.,2016-06-21 16:48:08,video,25,82,19,126
5281959998,Democrats focused on the weapons. Republicans emphasized terrorism.,2016-06-15 04:25:00,link,93,86,44,223
18807449704,This. Is. Nuts.,2016-06-18 16:26:59,link,92,4,30,126
112638779551,"This cub just wanted to be one of the guys on the golf course. 

Kristen Balboni for @TheBuzzer",2016-06-15 15:42:26,video,82,72,7,161
7245371700,"Wait, WHAT? Ancient methods for birth control included Lysol and ferrets?!",2016-06-17 16:26:19,video,154,19,27,200
52150999700,The families of Newtown victims are speaking out about the heartbreaking new documentary. 💔,2016-06-23 16:55:24,link,103,20,46,169
18807449704,Terrifying!,2016-06-22 12:30:01,link,141,64,15,220
13652355666,Watch the Cleveland Cavaliers celebrate winning the 2016 #NBAFinals!,2016-06-19 21:37:51,video,182,12,24,218
95926963131,U.S. Marine Corps veteran Richard Delgado Jr. is the definition of a hero.,2016-06-20 02:00:15,link,28,30,15,73
10606591490,She inspired a whole group of strangers to join in.,2016-06-23 05:30:08,link,20,91,3,114
25902406772,Dragan Bender getting a fresh look before the Draft.,2016-06-22 12:16:28,video,45,5,21,71
52150999700,The Red Hot Chili Peppers brought out that funk-rock sound we love in their new album.,2016-06-19 07:15:00,link,71,14,27,112
10513336322,"""I don't think anyone's even going to read the Chilcot report. Except perhaps historians. Do you know, it's longer than all the Harry Potter books put together?""",2016-06-20 05:20:01,link,45,3,29,77
25902406772,Toronto Raptors just got some serious size out of Austria.,2016-06-23 19:39:32,video,163,2,6,171
10606591490,Is it better to go cold turkey?,2016-06-18 11:01:09,link,191,43,44,278
7245371700,Did your favorite new hip-hop artist make the cut?,2016-06-19 21:24:01,link,129,28,40,197
86680728811,NASA's Juno probe is set to enter Jupiter's orbit after 5 years and a 2 billion mile journey through space.,2016-06-21 14:38:00,link,8,50,30,88
25902406772,Jason Pierre-Paul has a message for the Rookies.,2016-06-17 10:03:33,link,23,1,16,40
95926963131,Not all relationships end so gracefully.,2016-06-15 16:23:05,link,73,61,34,168
52150999700,*Breathes a sigh of relief*,2016-06-15 18:55:00,link,153,10,3,166
52150999700,You might remember these Orange Is the New Black stars from your other favorites like That '70s Show (Official)! 😱,2016-06-17 03:23:00,link,185,80,32,297
25902406772,Kevin Pillar has a knack for making awesome grabs.,2016-06-21 23:18:03,link,48,8,26,82
5281959998,"Judy Garland, who died 47 years ago today, never found peace of mind.",2016-06-22 15:25:00,link,106,4,11,121
13652355666,Florida police say Below Deck's Kate Chastain got into a domestic dispute with her girlfriend. http://usat.ly/1rq75v6,2016-06-15 12:58:00,video,155,96,39,290
7245371700,Camik? Camren? So. many. options.,2016-06-16 21:00:22,link,98,22,27,147
75932763901,MAJOR FAUX PAS!! See who had a nip slip on the red carpet! –> http://bit.ly/1TdcqQl,2016-06-21 20:00:00,photo,188,10,29,227
5281959998,"Speedy, meatless meals from The New York Times Food.",2016-06-18 13:55:00,link,92,9,14,115
25902406772,Which MLB squad has the best mascot?,2016-06-16 23:12:40,link,66,70,47,183
112638779551,Persistence pays off. Matt Borchert will play in his first U.S. Open Championship on Thursday.,2016-06-15 09:59:36,link,122,29,46,197
7245371700,"Life's a beach, and Fifth Harmony is just playing in the sand.",2016-06-23 21:54:38,link,31,100,12,143
10606591490,Here's how to do it.,2016-06-17 22:30:04,link,96,49,9,154
52150999700,These new Big Brother contestants are about to spend a record 99 days in the house together!,2016-06-18 21:00:00,link,49,11,6,66
95926963131,The 11-year-old's lifeless body was found wrapped in a blanket in a New Hampshire river.,2016-06-21 13:47:04,link,29,32,20,81
75932763901,SO CUTE! Click here to find out who shared this picture of their adorable baby girl —> http://bit.ly/28Nrbu5,2016-06-21 16:30:00,photo,10,65,9,84
13652355666,Oscar Pistorius appeared to cry silently as he walked toward the judge.,2016-06-15 12:22:00,link,153,18,34,205
75932763901,"Jessica Simpson's daughter, Maxwell, is typically the star of her famous mother's Instagram — but when was the last time you saw her son, Ace?! JUST WAIT until you see how grown up he looks: http://bit.ly/28JIqw6",2016-06-21 03:30:00,photo,193,60,49,302
7245371700,"Oh, so that's how Demi Lovato gets flawless skin.",2016-06-20 23:03:42,link,10,75,34,119
112638779551,Two reasons for LA Kings fans to cheer,2016-06-22 20:49:28,link,139,55,31,225
52150999700,The Charmed sisters gave a quick glimpse of what a Halliwell reunion would look like.,2016-06-19 02:26:00,link,52,80,49,181
25902406772,U.S. Soccer on the come up.,2016-06-17 00:04:10,link,73,13,13,99
13652355666,Trump's rhetoric was not always supported by the facts.,2016-06-23 04:02:13,link,110,17,26,153
112638779551,Changing coaches in-season wasn't a bad thing in the NBA and NHL this go-round.,2016-06-19 23:41:43,link,32,98,22,152
10513336322,"California is in the fifth year of a historic drought, which officials say has deprived trees of water, making them more vulnerable to attack from beetles.",2016-06-22 18:30:00,link,22,95,22,139
86680728811,"Fireworks set off inside a Phoenix Walmart, sparking fire; officials searching for two suspects. http://abcn.ws/1Ue0NqO",2016-06-17 16:10:33,video,144,37,3,184
75932763901,"Sarah Jessica Parker's twin daughters, Tabitha and Marion, don't look like this anymore! See how grown up the sisters look today (via Closer Weekly) —> http://bit.ly/28ZVa1b",2016-06-24 01:00:00,photo,68,62,13,143
18807449704,"""I also wanna wash my clothes using those abs haha.""",2016-06-18 15:27:00,link,28,55,21,104
86680728811,"President Barack Obama after meeting with victims' families in Orlando: ""After the worst of humanity reared its evil head, the best of humanity came roaring back."" http://abcn.ws/23e5mqH",2016-06-16 16:00:46,video,182,85,25,292
13652355666,"Sorry, no cigars yet.",2016-06-21 11:47:01,link,171,8,17,196
13652355666,It took one of the best performances in Finals history from LeBron James to deliver Cleveland its first major pro sports championship since the 1964 Browns.,2016-06-19 22:25:22,link,48,39,40,127
13652355666,That didn't take long.,2016-06-23 16:42:00,link,149,2,2,153
18807449704,Stunning!,2016-06-23 08:43:23,link,198,22,40,260
86680728811,"Golfer Rory McIlroy will not compete at the Olympics in Brazil because of the threat of the Zika virus. ""I've come to realize that my health and my family's health comes before anything else.""",2016-06-22 08:02:55,link,48,38,33,119
86680728811,"The violence depicted in the video can only be described as ""cold-blooded mowing, walking through the rooms mowing people down,"" one source tells ABC News. http://abcn.ws/1SbkHAh",2016-06-18 15:37:51,link,127,85,20,232
75932763901,"Remember the ""hot"" felon?! Well he's out of jail — and he's looking better than ever!",2016-06-16 01:30:00,link,189,27,34,250
10513336322,"""We are here to say we are going to defy the law in helping women obtain these pills and we are going to work to make the law unworkable and stand in solidarity with all women who want to have an abortion and have the right to do so.""",2016-06-21 10:00:00,link,68,64,23,155
75932763901,RIP — Our hearts are hurting for James Van Der Beek during this difficult time —> http://bit.ly/1XxXUGO,2016-06-19 19:00:00,photo,14,34,23,71
10513336322,What does urban corruption look like – and how is it measured? And is your city featured?,2016-06-21 03:40:00,link,7,63,47,117
10513336322,"""I have no idea how my children really feel about being on Instagram and even less how they might feel about it in the future. What if my sons grow up to be as private as my wife is?""",2016-06-19 12:20:00,link,127,44,19,190
10606591490,"Kim Kardashian West: ""I don't know why she just, you know, flipped all of a sudden.""",2016-06-16 12:00:50,link,69,64,42,175
86680728811,"The man who shot and killed former The Voice contestant Christina Grimmie was a loner who had harbored an obsession with the singer for at least six months to a year, according to police report.",2016-06-22 23:07:42,link,175,48,17,240
7245371700,"""Your bravery is the kind that people spend their entire lives trying to find.""",2016-06-15 19:19:22,link,192,96,50,338
75932763901,FAKE! She just totally exposed her BUTT PADS —>http://bit.ly/1Otz8z1,2016-06-20 05:15:00,photo,197,17,30,244
7245371700,Keep them coming Kanye.,2016-06-15 09:01:56,link,62,55,22,139
86680728811,"New Hampshire man describes being attacked by an alligator at Walt Disney World 30 years ago: ""It came out of the water, knocked me down, grabbed my leg and started to throw me around and try to pull me into the water."" http://abcn.ws/1Ubh67z",2016-06-16 11:53:46,link,2,83,7,92
10606591490,"""Republicans should be embarrassed, but they're not""",2016-06-20 17:49:18,link,35,63,19,117
18807449704,Incredible!,2016-06-18 23:00:00,link,105,52,30,187
25902406772,The WWE made a major announcement.,2016-06-21 14:28:26,link,165,26,35,226
52150999700,The new Survivor cast is an insanely interesting and intense group. 🙌🏻,2016-06-21 11:41:00,link,17,68,38,123
112638779551,"Las Vegas bookmakers say the Chicago Cubs' dominance is causing mayhem in their industry: ""It can't go on like this.""",2016-06-21 16:21:37,link,96,26,44,166
75932763901,SEXY MAMA! We bet this star's four children were MORTIFIED after seeing this photo on Instagram —> http://bit.ly/28KZu5t,2016-06-20 18:00:00,photo,79,29,44,152
95926963131,We know it's a workout for the horse—now how about the rider? (via People Great Ideas),2016-06-20 05:00:57,link,155,48,33,236
7245371700,Cue the nervous laughter.,2016-06-17 09:57:39,link,30,18,20,68
25902406772,Every other year the San Francisco Giants are dominant.,2016-06-19 11:04:02,link,179,4,28,211
5281959998,"Get some tips for performing at your peak. We're at the Higher Ed Leaders Forum, where two experts on maximizing performance and motivation are sharing the latest findings. 

The Times's Charles Duhigg is talking with Amy Cuddy of the Harvard Business School and Carol S. Dweck of Stanford University. Please leave questions in the comments, and the panelists will be happy to answer them.",2016-06-20 17:45:34,video,103,35,2,140
5281959998,"Over cookies at The White House, President Barack Obama and Bryan Cranston spoke about fatherhood, celebrity and ""Between Two Ferns.""",2016-06-19 15:25:01,link,150,78,4,232
13652355666,"DraftKings CEO Jason Robins said that a possible merger between his company and FanDuel is a ""very interesting idea.""",2016-06-19 01:05:04,link,20,51,50,121
95926963131,Add Chrissy Teigen to the list of epic rollercoaster snaps. 😂 (via People Babies),2016-06-19 12:01:29,link,73,59,27,159
25902406772,The Cleveland Browns will hope to continue the city's new winning ways.,2016-06-20 20:37:37,link,61,72,14,147
5281959998,They've embraced the existence of a third gender (neither male nor female) as part of life. But the bathroom debate has posed a challenge.,2016-06-22 14:43:46,link,195,28,33,256
7245371700,Can you believe that was almost 13 years ago?,2016-06-16 23:23:27,link,157,46,33,236
5281959998,"They also said that ""very hot"" coffee was ""probably carcinogenic,"" so let that hot coffee cool off.",2016-06-15 09:55:00,link,200,31,10,241
75932763901,"Just after announcing her pregnancy with baby No. 2, Blake Lively makes an upsetting confession about her marriage to Ryan Reynolds—> http://bit.ly/28L5VUj",2016-06-21 19:30:00,photo,136,84,17,237
25902406772,San Diego Chargers  veteran Antonio Gates relies on his little bro.,2016-06-19 13:36:33,link,190,31,39,260
52150999700,A very special and touching performance from Broadway stars will be featured on Maya & Marty. ❤️,2016-06-20 15:41:00,link,166,46,13,225
86680728811,"JUST IN: Authorities are considering at least two charges against the wife of the Orlando shooter, sources familiar with the investigation tell ABC News.",2016-06-16 15:38:38,photo,181,34,40,255
5281959998,The group stage of UEFA EURO is almost over. Here's how your team can advance.,2016-06-19 00:55:00,link,164,55,33,252
7245371700,Selena Gomez and Christina Grimmie's friendship went way back.,2016-06-20 03:24:17,link,46,98,36,180
112638779551,The champagne was flowing and J.R. Smith lost his shirt.,2016-06-20 07:36:50,link,159,17,18,194
18807449704,Elon Musk just revealed a secret about the Tesla Model S.,2016-06-20 09:01:48,link,118,62,14,194
25902406772,Happens to the best of us...,2016-06-15 20:48:33,link,184,86,16,286
25902406772,The champ is still not satisfied.,2016-06-21 11:58:19,link,181,13,50,244
13652355666,"""Absolutely sickened to hear of the assassination of Jo Cox ... A rising star, mother, and wife,"" Gabby Giffords stated.",2016-06-16 16:18:00,link,120,48,7,175
5281959998,"She was a track star who doped. He was an anti-doping officer. They got married, nearly divorced and then blew the whistle on Russia's state-run doping program.",2016-06-22 09:55:00,link,101,16,6,123
13652355666,"After her prank backfired, Darby Risner probably doesn't ""love"" Barney anymore.",2016-06-23 20:42:00,video,35,31,11,77
5281959998,"The police said they recovered 5 pistols, an AR-15 assault rifle and a 12-gauge shotgun.",2016-06-23 08:55:00,link,36,68,1,105
95926963131,Joe Biden is offering up his best parenting advice!,2016-06-19 22:30:06,link,137,24,39,200
10513336322,"""It's hard to imagine Trump responding to a personal attack – like the one he fired at Obama after Orlando – in anything other than a personal way. What separates these two men isn't just a worldview, it's a question of temperament.""",2016-06-21 14:00:00,link,79,57,19,155
112638779551,Will WWE's Bray Wyatt make his comeback from a calf injury at Money In The Bank this weekend?,2016-06-17 13:20:15,link,37,50,38,125
52150999700,Wonder Woman and Don Draper are your new favorite comedic couple! 😂,2016-06-22 11:06:00,link,34,5,5,44
112638779551,This Argentina fan is lucky Leo Messi is such a cool guy (and that security was asleep).,2016-06-22 09:28:15,link,173,98,3,274
10513336322,"""Some of the poorest areas in the UK have benefited from regeneration bankrolled by billions of euros of EU structural funding.""",2016-06-16 01:00:00,link,134,63,36,233
112638779551,There were at least a few empty seats prior to Game 6 of the NBA Finals.,2016-06-16 20:20:44,link,54,84,15,153
112638779551,We wont' get to see Stephen Strasburg vs. Clayton Kershaw on Monday night.,2016-06-20 21:19:58,link,179,16,44,239
10513336322,"There are particular concerns that irregularly shaped tablets, often with no score lines to easily split them, are confounding harm reduction advice that tells users to test their reaction to a half or even a quarter of a pill rather than swallowing the whole thing.",2016-06-15 12:00:00,link,164,96,11,271
13652355666,The singer was suffering from severe dehydration.,2016-06-17 00:09:00,link,21,56,23,100
10513336322,"""Suddenly there's a real risk of a capsize. There are 140 people crammed onboard this flimsy raft, including 38 women, 15 of them pregnant. When they shift their weight, the boat becomes unsteady. Its inflatable tubes, already deflating, begin to sag under the increased pressure. Some of the passengers are getting crushed.""",2016-06-17 03:00:00,link,77,15,46,138
75932763901,"Just after announcing her pregnancy with baby no. 2, Blake Lively makes an upsetting confession about her marriage to Ryan Reynolds —> http://bit.ly/28L5VUj",2016-06-21 11:30:00,photo,90,22,33,145
13652355666,Who says walking on water is impossible?,2016-06-19 23:45:00,link,188,32,48,268
25902406772,Cristiano Ronaldo is GOOD.,2016-06-22 12:54:03,link,151,33,13,197
10606591490,Why the summer solstice may be the happiest day of the year. http://ti.me/28JCyWb,2016-06-20 19:00:37,video,191,21,17,229
5281959998,"The Panama Canal, an artery nourishing the world economy, is getting an upgrade. Things are not going as planned. http://nyti.ms/28NBXxH",2016-06-22 18:55:00,video,154,30,43,227
18807449704,*face-palm*,2016-06-23 06:30:00,link,149,98,15,262
5281959998,"George W. Bush is back, and he's trying to help save GOP senators endangered in part by Donald J. Trump.",2016-06-16 20:55:00,link,87,64,30,181
52150999700,"When Matthew McConaughey first met Camila Alves, he thought she was a lot more than ""alright, alright, alright!"" 😍",2016-06-22 09:36:01,link,198,99,45,342
75932763901,ON AGAIN?! This couple just started rekindling an old flame —> http://bit.ly/292M7fY,2016-06-24 20:30:00,photo,177,26,16,219
10513336322,"""Talk about Freaky Friday: Lindsey Lohan has woken up a passionate supporter for Remain.""",2016-06-23 21:40:04,link,74,61,26,161
10606591490,"""People want to see borders.""",2016-06-24 07:01:05,link,84,96,13,193
86680728811,"Recent high school grad declines $1,000 scholarship over a difference in principle. ""It would just be hypocritical for me to take money from a company that does the opposite of what I'm going to school for.""",2016-06-16 22:42:52,link,23,67,45,135
95926963131,"Just hours after Princess Charlotte's Buckingham Palace balcony debut, her pale pink Mary Jane shoes sold out. (via People Royals)",2016-06-19 20:20:00,video,10,41,27,78
112638779551,LeBron James reportedly has watched the movies six times this postseason but wouldn't name one phrase he liked.,2016-06-16 11:49:52,link,180,44,10,234
10513336322,"Barack Obama's immigration program to protect some families from deportation relief remains blocked by a court order, after the supreme court deadlocked in a 4-4 tie, a decision crucial to the president's legacy.",2016-06-23 11:40:00,link,180,52,8,240
18807449704,Wow!,2016-06-23 19:39:00,link,165,24,19,208
112638779551,"The Derrick Rose era in Chicago is officially over, as Jimmy Butler says farewell to the former MVP.",2016-06-22 21:09:15,link,119,98,45,262
95926963131,It sounds like Prince William isn't a fan of Princess Kate's cooking skills. (via People Royals),2016-06-22 17:17:03,link,2,3,22,27
25902406772,"One thing is not up for debate...

LeBron James is building an all-time résumé.",2016-06-20 11:49:01,photo,140,80,28,248
10513336322,Britain: land of hope and gloriously odd polling stations.,2016-06-23 13:40:00,link,19,57,18,94
10513336322,"Patti Smith: ""I'm going to be 70 soon. And I know I can't sing like Amy Winehouse or Rihanna. I can't rely on that physical beauty or certain things that you have when you're young. But what I can rely on is that, when I go on stage, I am only there for one reason and that's to communicate with the people.""",2016-06-17 04:00:00,link,184,89,37,310
75932763901,"If you thought Smith Jerrod from 'Sex and the City' was hot on the show, just WAIT until you see what he looks like now! (via Closer Weekly) —> http://bit.ly/1nYTdHt",2016-06-17 04:00:00,photo,152,88,15,255
18807449704,"Unfortunately, this one took a wrong turn somewhere.",2016-06-22 03:00:00,link,96,90,9,195
13652355666,What exactly is the watch list?,2016-06-15 04:30:00,link,12,1,24,37
95926963131,"She may be the selfie queen, but that doesn't mean Kim Kardashian West always feels camera-ready.",2016-06-15 09:34:08,link,188,74,12,274
112638779551,Tristan Thompson's remarkable performance Thursday night helped the Cleveland Cavaliers force a Game 7 in a series they once trailed 3-1.,2016-06-17 05:04:38,link,88,6,29,123
25902406772,The Game 7 blog is LIVE.,2016-06-19 18:30:55,link,176,60,36,272
86680728811,Happy 34th birthday to Prince William! abcn.ws/28LCgOv,2016-06-21 09:57:57,photo,32,96,34,162
52150999700,"Fred Armisen prides himself on being able to affect any accent. Well, almost any.",2016-06-16 06:40:16,link,200,42,28,270
95926963131,"After his life was tragically cut short, Lane Graves will be laid to rest on Tuesday.",2016-06-19 12:22:35,link,50,45,24,119
18807449704,Khloé Kardashian has a lot to say.,2016-06-15 18:50:00,link,57,14,44,115
7245371700,Where you'll play as Donda West.,2016-06-19 14:12:28,link,141,23,31,195
86680728811,Walmart says it's cutting jobs at about 500 locations in the Western region of the United States.,2016-06-15 22:45:13,link,106,81,4,191
75932763901,LOW BLOW! We can't believe Scott Disick would bring up something SO PERSONAL about about Kourtney Kardashian's sex life!! Find out what he said —> http://bit.ly/1YwKXwE,2016-06-17 19:00:01,photo,15,98,8,121
95926963131,Dad is still Chris Hemsworth's hunkiest role yet!,2016-06-16 07:22:04,link,128,33,29,190
52150999700,Tony Hale breaks down the dark side of Frozen and it's hilarious. 🙌🏼,2016-06-18 10:56:00,link,93,93,41,227
25902406772,These Father's Day hats are pretty cool.,2016-06-16 14:05:20,link,136,32,40,208
13652355666,"The Confederate flag belongs ""in the dustbin of history,"" Mississippi protesters say. http://usat.ly/1Yr6iHz",2016-06-16 17:50:00,video,163,6,43,212
5281959998,The suspect in Jo Cox's killing is said to have bought books on how to make explosives from a U.S. neo-Nazi group.,2016-06-17 05:56:00,link,111,77,37,225
25902406772,No one is stopping the Texas Rangers.,2016-06-19 09:58:02,link,31,66,49,146
25902406772,Bruce Arians still isn't happy about the way his time in Pittsburgh ended.,2016-06-17 16:25:46,link,20,12,31,63
7245371700,Who exactly is marshmello? Like Skrillex? Maybe Tiësto? An investigation.,2016-06-23 16:40:05,link,183,87,38,308
7245371700,Probably the weirdest Game of Thrones hangout session ever.,2016-06-15 03:06:48,link,17,64,22,103
112638779551,"""Winning golf tournaments & trying to extend the lead of being No. 1 in the world is all I think about."" - Jason Day. #USOpen",2016-06-18 16:00:53,video,70,80,30,180
86680728811,"Orlando massacre victim's siblings say their brother died saving his girlfriend's life. ""He was our superhero."" http://abcn.ws/1UCckzA",2016-06-16 22:19:51,video,139,98,34,271
75932763901,"UNRECOGNIZABLE! You know this young star, but we bet you've NEVER seen her without her makeup done! –> http://bit.ly/1qyuY41",2016-06-20 02:45:00,photo,132,97,7,236
75932763901,BABY BUMP ALERT!! This pregnant star is debuting her baby bump for the very first time! (via Life & Style Weekly) —> http://bit.ly/1YyCzwo,2016-06-18 17:15:00,photo,187,56,11,254
18807449704,Donald J. Trump has a message waiting for him when he arrives in Scotland.,2016-06-21 14:01:00,link,187,58,30,275
25902406772,Kevin Durant has NO mercy for these children.,2016-06-22 12:38:55,link,26,34,37,97
75932763901,Katie Holmes just shared a rare photo of herself with daughter Suri Cruise — and fans can't get over how grown up and gorgeous she looks today! See the pic (via Closer Weekly) —> http://bit.ly/1UdmgQr,2016-06-18 04:00:00,photo,20,55,34,109
10513336322,"""Medicine has an anaesthetic relationship to pain – it wants to rid the patient of it. Poetry's relationship is aesthetic – it wants pain to speak. """,2016-06-19 06:40:01,link,47,98,48,193
10606591490,Beyoncé would be proud.,2016-06-23 19:01:30,link,2,72,43,117
18807449704,From almost going in the trash to treasure. 👠,2016-06-23 21:11:00,link,34,93,25,152
112638779551,"The NBA Draft is now just HOURS away, and the Philadelphia 76ers, LA Lakers and Boston Celtics are on the clock... 

So who will YOUR team draft? Our third and final Mock Draft, via Aaron Torres....",2016-06-22 08:06:19,link,21,86,27,134
25902406772,Tim Lincecum had a pretty solid debut.,2016-06-18 21:58:45,link,164,50,32,246
5281959998,Here's what you need to know about Brexit.,2016-06-20 16:25:00,link,181,48,41,270
7245371700,"""I am not perfect, and I never will be.""",2016-06-24 00:20:28,link,48,35,21,104
52150999700,The Foo Fighters frontman has the BEST story of jamming with Taylor Swift (and Paul McCartney). 😂,2016-06-23 11:13:58,link,53,50,40,143
52150999700,Bill Hader's Arnold Schwarzenegger impression has reached a new level of hilarious. 😂,2016-06-23 10:02:00,link,99,62,43,204
7245371700,"From sexy to ""zexy.""",2016-06-20 12:59:04,link,25,99,13,137
10606591490,Taylor Swift could be the next Nancy Drew.,2016-06-23 18:00:23,link,174,42,1,217
7245371700,I don't think I ever envied these celebs more than I do now :),2016-06-24 00:49:34,link,198,82,10,290
25902406772,Maybe he wanted to take it for a swim? Have to hear both sides.,2016-06-22 09:59:58,link,2,34,38,74
75932763901,"SERIOUSLY?! She wants $84,000 per MONTH in child support from her famous baby daddy! Click here to find out who—> bit.ly/1V9oxRs",2016-06-19 21:00:00,photo,110,98,12,220
18807449704,Shut it down.,2016-06-18 14:27:06,link,197,32,4,233
5281959998,"""If you like seeing things that the government does not want you to see, you'll probably enjoy Dan Barry's piece on the agency that oversees boxing and mixed martial arts in New York."" —Jason Stallman, Sports Editor",2016-06-23 16:57:47,link,177,9,35,221
52150999700,"Before Leonardo DiCaprio was in Titanic, he was selling bubble gum. 😂",2016-06-23 01:03:00,link,157,100,22,279
10606591490,8. Your role changes.,2016-06-17 04:00:12,link,182,37,14,233
13652355666,Here's the bottom line.,2016-06-15 18:57:01,link,188,72,32,292
52150999700,Team Machine suffered one more casualty in the final battle against Samaritan in the series finale of Person of Interest.,2016-06-21 22:02:20,link,176,50,46,272
75932763901,"She just announced her pregnancy a few months ago, but this reality star just can't seem to keep her clothes on! —> http://bit.ly/1tuZJbR",2016-06-15 08:30:01,photo,125,63,48,236
52150999700,Save the date–the documentary on Hamilton: An American Musical is on the way!!!,2016-06-16 22:55:00,link,68,57,4,129
95926963131,A 51-year-old man was arrested on a series of disturbing charges after authorities retrieved 12 girls from his home.,2016-06-20 12:52:06,link,155,28,45,228
10513336322,"""The United States desperately needed a third sex classification of non-binary for all of the people such as myself that simply do not fit into the existing binary system of just male or female.""",2016-06-16 11:00:00,link,176,20,23,219
112638779551,New York's staff ace saw the team doctor Wednesday afternoon.,2016-06-22 16:50:58,link,188,57,34,279
7245371700,That's definitely not the logical thing to do...,2016-06-16 19:21:09,link,105,17,31,153
112638779551,"""LeBron James is the greatest team player off all time. By far.""

Chris Webber explains why LeBron has leaped Magic Johnson.",2016-06-20 17:33:00,link,182,17,7,206
25902406772,This is very cool.,2016-06-21 12:29:35,link,65,78,41,184
13652355666,"Hillary Clinton told USA TODAY about her plans to make the case for why Donald J. Trump is ""temperamentally unfit"" to manage the nation's economy.",2016-06-15 16:14:00,link,44,16,32,92
75932763901,Kelly Clarkson's daughter River Rose is getting SO big! See her latest photo (via Closer Weekly) —> http://bit.ly/1J7w3be,2016-06-18 05:30:00,photo,51,58,17,126
95926963131,Selma Blair was met by paramedics when she returned from her trip to Mexico.,2016-06-20 20:14:54,link,48,35,49,132
112638779551,Fans came out in throngs to celebrate the Pittsburgh Penguins' fourth Lord Stanley's Cup victory.,2016-06-15 16:05:25,link,55,10,37,102
10606591490,Taylor Swift shared a touching note on Instagram.,2016-06-19 23:00:10,link,89,52,33,174
7245371700,"""Being queer doesn't matter — until it does.""",2016-06-21 21:50:01,link,143,14,18,175
95926963131,Some recent events foreshadowed Taylor Swift and Tom Hiddleston's surprise cuddle session.,2016-06-15 21:57:44,link,2,79,45,126
25902406772,The Tampa Bay Buccaneers are just too scared...,2016-06-18 12:18:57,link,28,34,35,97
112638779551,Ever wonder what caddies and players to discuss before a shot? Hear what Jason Day and his caddie discussed before a key shot in the U.S. Open Championship. #LookAgain #USOpen,2016-06-17 19:16:51,video,44,4,29,77
7245371700,Which scene messed with your mind the most?,2016-06-16 14:37:04,link,9,14,23,46
18807449704,"Ugh, Instagram",2016-06-21 06:29:21,link,141,29,26,196
112638779551,"This young golfer perfectly chips a golf ball on fire to ignite some fireworks! Yes, you read all that right. 

Andy Nesbitt for @TheBuzzer",2016-06-15 18:44:27,video,137,81,39,257
52150999700,"Get to know Teen Wolf star Tyler Hoechlin, who is joining Supergirl as the one and only Superman! share.ew.com/TZ4BZP1 👊🏼",2016-06-16 14:19:01,video,95,60,41,196
5281959998,"And with the third pick, the NBA draft could officially begin.",2016-06-23 21:40:18,link,14,22,18,54
7245371700,"Luckily, there is a solution and many states are getting with the program.",2016-06-18 00:12:54,link,163,19,22,204
52150999700,Nick Cannon gets REAL about his divorce with Mariah Carey in a revealing new track.,2016-06-16 22:35:00,link,188,78,49,315
18807449704,Use this Instagram feature sparingly during a breakup.,2016-06-17 12:11:37,link,33,31,43,107
52150999700,Beyoncé is the latest star to pay tribute to the Orlando victims during performances this week.,2016-06-15 07:16:44,link,37,6,48,91
25902406772,Shoutout to JR too for misplacing his.,2016-06-20 12:28:48,photo,195,7,10,212
5281959998,"When members of Westboro Baptist Church protested the funeral of an Orlando shooting victim, the community responded with messages of peace. http://nyti.ms/28Jd1pY",2016-06-20 13:55:00,video,44,99,10,153
13652355666,The gifts pops never knew he wanted.,2016-06-17 12:16:00,link,149,81,28,258
112638779551,"Beginning tomorrow, watch FOX Sports golf coverage from tee to green LIVE in virtual reality with the NextVR app!",2016-06-15 12:11:10,link,168,92,12,272
5281959998,"""The Supreme Court lets immigrants down once again,"" Luba Cortés writes in The New York Times Opinion Section.",2016-06-23 18:56:40,link,106,9,39,154
7245371700,This change needed to happen.,2016-06-16 13:27:36,link,76,41,50,167
18807449704,Uh-oh.,2016-06-20 19:37:00,link,46,45,44,135
112638779551,Bubba Watson is spending Day 2 of the U.S. Open Championship taking his 4-year-old to the movies.,2016-06-17 10:07:04,link,134,16,4,154
13652355666,"It was supposed to be a final resting place for more than 1,000 animals, including the country's first police dog.",2016-06-20 13:23:00,link,154,61,7,222
10513336322,"""Politics as practised for a generation is upended; traditional party allegiances are shredded; the prime minister's authority is bust – and that is just the parochial domestic fallout. A whole continent looks on in trepidation. It was meant to be unthinkable, now the thought has become action. Europe cannot be the same again.""",2016-06-24 00:20:00,link,181,62,14,257
86680728811,Ex-United Nations General Assembly Chief John Ashe died on Wednesday. He was 61.,2016-06-23 01:44:10,link,36,9,35,80
10606591490,"""In climbing, gender really doesn't matter.""",2016-06-19 06:00:23,link,1,64,38,103
25902406772,U.S. Soccer is semifinal bound!,2016-06-16 22:33:31,photo,127,48,40,215
95926963131,PEOPLE is hitting up Hollywood Blvd and dishing out a few hilarious quizzes inspired by Comedians in Cars Getting Coffee!,2016-06-18 09:40:58,video,200,88,25,313
7245371700,"""Is there anywhere that we can feel safe?""",2016-06-16 20:31:10,link,18,3,32,53
5281959998,"""He was just agitated about everything,"" the Orlando gunman's former co-worker recalled. ""Always shaken. Always agitated. Always mad.""",2016-06-18 12:25:00,link,160,1,22,183
112638779551,"Conor McGregor has an interesting workout drill and a new workout partner?? Beware, Nate Diaz.

Andy Nesbitt for @TheBuzzer",2016-06-22 15:51:20,video,78,49,16,143
75932763901,Halle Berry's rarely-photographed daughter is all grown up! Wait until you see Nahla today (via Closer Weekly) —> http://bit.ly/25AYB7f,2016-06-19 16:45:00,photo,194,1,2,197
25902406772,"The final buzzer sounded, and the emotions came pouring out.",2016-06-19 22:15:21,link,153,22,16,191
52150999700,Just keep swimming...the future (and past!) of Finding Nemo and Finding Dory is surprisingly murky.,2016-06-20 13:18:00,link,144,12,41,197
10606591490,"Like mother, like son and daughter.",2016-06-20 20:30:06,link,3,76,34,113
13652355666,"The 2-year-old who was killed by an alligator at a Disney World resort will be laid to rest Tuesday. (Photo: AFP/Getty)

More news you need to know:  usat.ly/28LAdZt",2016-06-21 06:01:00,photo,32,7,30,69
95926963131,Ginger Zee was shocked when she stepped off the Dancing with the Stars ballroom floor and onto the bathroom scale.,2016-06-22 12:10:07,link,85,25,47,157
86680728811,"NEW: Anton Yelchin, a charismatic and rising actor best known for playing Chekov in the new ""Star Trek"" films, has died at the age of 27 after a fatal traffic collision. http://abcn.ws/1Y2Sp3O",2016-06-19 13:49:26,link,52,14,27,93
18807449704,You can stop your stanky foot problem and save your friendships in the process.,2016-06-20 00:00:00,link,93,37,38,168
75932763901,CONGRATULATIONS! This famous couple will welcome their first child together thanks to IVF — it's a girl: http://bit.ly/28Jz14I,2016-06-21 00:30:00,photo,131,95,29,255
18807449704,A highlight included Stephen Curry throwing his mouthpiece and hitting a fan.,2016-06-17 06:30:01,link,67,8,20,95
52150999700,"Unlike 12 Years a Slave, Matthew McConaughey's latest drama lacks vigor.",2016-06-21 18:05:00,link,137,62,27,226
25902406772,Rory McIlroy will not be participating in the 2016 Rio Olympics.,2016-06-22 09:23:59,link,9,30,25,64
18807449704,Global markets have entered into an absolute freakout,2016-06-24 05:00:01,link,192,31,15,238
75932763901,IT'S A BOY! See which star just welcomed Baby No. 2 (via Closer Weekly) —> http://bit.ly/28II7Dt,2016-06-20 12:00:00,photo,164,96,50,310
112638779551,Watch South African golfer Ernie Els share his good fortune with a fan at the U.S. Open Championship.,2016-06-17 17:16:18,link,113,50,24,187
52150999700,Matthew McConaughey likes to keep it real. 💯,2016-06-22 12:41:00,link,109,82,49,240
95926963131,Noah is using his disabilities to bring a message of anti-bullying to kids. (via PEOPLE Pets),2016-06-19 02:00:26,link,135,11,49,195
10606591490,Good news for Taylor Swift.,2016-06-20 15:30:35,link,45,24,17,86
5281959998,"If you have a terrible disease for which medicine has little to offer, then what do you have to lose by turning to a parasite?",2016-06-16 10:55:00,link,75,51,33,159
7245371700,Dj Dahi is mad talented.,2016-06-23 19:58:06,link,92,13,39,144
13652355666,"""It has never been like this.""",2016-06-16 21:50:00,link,7,22,18,47
52150999700,There's no friendship quite like this one on Sherlock. (via HelloGiggles),2016-06-21 00:21:00,link,12,70,13,95
112638779551,The victory parade is forthcoming.,2016-06-16 10:03:43,link,125,10,40,175
10513336322,"""I don't like it when you align yourself with racists, thugs and dog-whistlers. It makes me feel that you want to align yourself with racists, thugs and dog-whistlers to racists and thugs.""",2016-06-18 09:20:00,link,179,91,6,276
10606591490,"""It's easy to pile on calories by asking for a little more of this, then a refill of that—without realizing that the calories surpass those in McDonald's meals.""",2016-06-21 22:30:15,link,62,9,48,119
95926963131,Johnny Depp and Amber Heard's courtroom showdown has been postponed.,2016-06-16 20:38:03,link,121,62,15,198
13652355666,Give dad the gift of cold brew.,2016-06-17 14:10:00,link,21,38,32,91
7245371700,Team Tormund or team Lannister?,2016-06-19 17:32:05,link,171,61,42,274
5281959998,"For 16 days, ""The Floating Piers,"" a saffron-colored walkway, will connect 2 small islands in a lake in Northern Italy to the mainland.",2016-06-17 00:55:00,link,18,67,45,130
5281959998,"""Led by Boris Johnson, British news media have been smearing the European Union for decades,"" Martin Fletcher writes in The New York Times Opinion Section.",2016-06-23 02:25:00,link,166,73,30,269
25902406772,"Alex is totally the Michigan State of the show...

(COLLEGE FOOTBALL SEASON, PLEASE HURRY)",2016-06-20 14:33:38,link,152,38,4,194
75932763901,THE RING IS OFF! Click here to find out who called off their engagement! —> http://bit.ly/28JuGSX,2016-06-20 10:56:21,photo,187,97,24,308
52150999700,Beauty and the Beast is full of fun hidden gems. ❤️  (via HelloGiggles),2016-06-24 00:13:00,link,145,86,31,262
7245371700,"Isn't it a little hot out for that, Rihanna?",2016-06-20 06:59:32,link,43,83,41,167
7245371700,"""It was pure magic.""",2016-06-15 00:33:31,link,56,32,30,118
112638779551,"Social media reaction rolls in from other golfers as everyone awaits final word on Dustin Johnson's potential 1-stroke penalty. #USOpen

Rory McIlroy, Jordan Spieth and Rickie Fowler all weigh in.",2016-06-19 18:13:32,video,104,95,28,227
10513336322,"""Satya Nadella is betting that social networks will be at the centre of our professional lives.""",2016-06-18 13:00:00,link,165,19,25,209
7245371700,Cheers to more Taylor Swift + Tom Hiddleston Beyoncé dance-offs like this.,2016-06-16 10:05:27,link,75,7,29,111
112638779551,Dustin Johnson made sure a potential penalty stroke wouldn't matter.,2016-06-19 19:10:07,link,12,34,34,80
25902406772,The Philadelphia Eagles might have the most unique player in the NFL.,2016-06-21 09:41:33,link,182,22,46,250
112638779551,About time!,2016-06-18 02:15:58,link,63,28,42,133
112638779551,Can #DustinJohnson end his demons and win his first major? #USOpen #Oakmont,2016-06-19 10:48:30,link,141,52,9,202
86680728811,"House Homeland Security Chairman Michael McCaul tells This Week there are some ""disturbing flags"" in the Orlando shooting case and that his committee will conduct oversight hearings to determine whether the FBI did all it could to investigate them prior to the attack: http://abcn.ws/1Y2Lqbd",2016-06-19 14:37:29,video,58,69,31,158
25902406772,Some NBA teams are concerned about Denzel Valentine's right knee.,2016-06-16 13:12:15,link,107,89,8,204
25902406772,Ilya Bryzgalov is eyeing a comeback.,2016-06-16 12:34:56,link,153,48,38,239
7245371700,Travis Scott is playing with fire.,2016-06-15 10:07:06,link,166,43,13,222
18807449704,It's basically Blake Lively vs. The Shark and you're going to love it.,2016-06-23 07:00:00,link,33,75,31,139
52150999700,"Anne Hathaway is ""honored and inspired"" by her latest role.",2016-06-15 17:09:00,link,118,7,35,160
18807449704,What. Just. Happened.,2016-06-18 17:25:00,link,75,38,47,160
10606591490,Many in the U.K. appear to be panic Googling.,2016-06-23 22:00:09,link,38,97,24,159
10606591490,No more deleting selfies to make room in the camera roll.,2016-06-16 05:00:18,link,24,92,41,157
25902406772,The Jacksonville Jaguars have high expectations for this rookie.,2016-06-15 14:25:40,link,94,67,23,184
5281959998,"While you're watching Slovakia on the field during UEFA EURO, see in real time its chances of advancing to the next round.",2016-06-20 01:35:00,link,42,58,41,141
13652355666,"Yes, this is real.",2016-06-17 23:20:00,link,45,63,29,137
75932763901,SO FIT! This 70-year-old star just flaunted her toned behind while on vacation! Find out who (via Closer Weekly) —> http://bit.ly/28UPUNg,2016-06-23 12:00:00,photo,50,51,26,127
75932763901,TROUBLE IN PARADISE? Liam Hemsworth makes a bold move that completely shocks Miley Cyrus — and the news is really upsetting fans —> http://bit.ly/28Oo5UT,2016-06-23 15:30:00,photo,84,48,24,156
13652355666,The big moment is Monday at 6:34 p.m. ET.,2016-06-20 02:40:00,link,64,23,21,108
7245371700,Things get tense between her and Jon Snow. (via Refinery29),2016-06-16 11:24:07,link,10,63,35,108
13652355666,"Oh, Twitterverse.",2016-06-23 21:30:00,link,111,81,37,229
112638779551,The signees had requested to be released from their letters of intent amid sexual assault allegations that led to Baylor University coach Art Briles' dismissal.,2016-06-23 18:21:17,link,195,8,21,224
5281959998,"""If anyone should be concerned about protecting the individual right to bear arms, it's LGBT people."" Read on in The New York Times Opinion Section.",2016-06-22 10:52:54,link,142,59,22,223
25902406772,This is different and awesome.,2016-06-23 12:13:32,link,121,85,17,223
10606591490,"The long-awaited showdown for Winterfell is said to be the ""biggest"" action sequence in the HBO drama's history",2016-06-15 19:30:21,link,88,40,17,145
112638779551,"The Boston Red Sox are reportedly exploring trades for an ace, but they shouldn't give up Xander Bogaerts or Mookie Betts.",2016-06-20 12:01:42,link,175,74,30,279
25902406772,Brandon Ingram will be a member of the LA Lakers.,2016-06-23 18:50:23,link,200,58,9,267
112638779551,"Herschel Walker still does 1,500 pushups a day and is looking for his next MMA fight.",2016-06-23 12:07:42,link,43,94,21,158
7245371700,This is the kind of convo we should be having when talking about this.,2016-06-16 10:00:06,link,12,17,21,50
86680728811,"TOMORROW: After the Orlando mass shooting, U.S. Attorney General Loretta Lynch and House Homeland Security Committee Chair Rep. Michael McCaul, R-Texas, come to This Week. Tune in! http://abcn.ws/1Y1qfGC",2016-06-18 22:00:42,link,60,85,6,151
52150999700,Spider-Man fans are going to freak out from the TRUE name of this major story.,2016-06-17 10:03:00,link,140,93,24,257
75932763901,"Mila Kunis and Ashton Kutcher normally keep their little girl, Wyatt, out of the spotlight — that's why this photo has fans totally freaking out! (via Closer Weekly) —> http://bit.ly/28xwfK9",2016-06-15 05:30:00,photo,72,65,41,178
52150999700,Jennifer Aniston and Modern Family's Ty Burrell look so adorable in  this new animation. 😍,2016-06-18 18:18:00,link,122,39,22,183
7245371700,The Juicy renaissance is upon us.,2016-06-15 23:19:21,link,129,12,16,157
25902406772,Matt Marshall and more put on a show at the U.S. Open.,2016-06-17 16:27:40,link,81,7,37,125
7245371700,Summermash is about to be a smash hit.,2016-06-20 16:32:41,link,112,65,40,217
52150999700,"From Zac Efron to Chris Hemsworth, this summer is FULL of sexy men. 😍",2016-06-21 01:04:00,link,192,33,7,232
112638779551,Former WWE superstar CM Punk - The Cult of Personality makes his debut at UFC 203 in Cleveland.,2016-06-23 03:27:35,link,94,55,7,156
13652355666,"Disney is making its ""Frozen"" franchise snow.",2016-06-21 04:25:00,link,177,76,43,296
25902406772,Paul George has a lot of love for Kobe Bryant.,2016-06-15 12:02:40,link,6,19,49,74
13652355666,A jury found former Vanderbilt player Brandon Vandenburg guilty as-charged in the rape of an unconscious woman in his dorm room nearly three years ago.,2016-06-18 19:11:58,link,168,18,50,236
10513336322,"""As I begin my last few months as chief inspector, it saddens me immeasurably to say frankly that we are still letting down our poorest children.""",2016-06-23 01:40:00,link,130,41,38,209
18807449704,Mark Zuckerberg covers up his webcam. Here's why you should too.,2016-06-22 11:13:52,link,148,81,12,241
112638779551,Never forget. #NationalSelfieDay,2016-06-21 12:38:38,video,118,60,32,210
13652355666,"The The New York Times, The Huffington Post, CNN, BuzzFeed, Vox, Mashable and Tastemade were among the media companies listed.",2016-06-22 01:00:00,link,107,13,31,151
112638779551,Dan Marino introduces you to the famed Duquesne Incline. #USOpen,2016-06-16 13:11:39,video,145,9,4,158
112638779551,WWE went to China and Yao Ming made John Cena look so tiny,2016-06-16 09:40:11,link,170,51,36,257
10606591490,"""Snow White, Cinderella and other Disney Princesses have some explaining to do.""",2016-06-22 16:30:22,link,185,66,4,255
95926963131,The second wife of #Orlando killer Omar Mateen has reportedly said she pleaded with him not to do anything violent.,2016-06-15 13:34:03,link,44,41,30,115
112638779551,"With Game 6 just hours away, LeBron James has bigger things to worry about than t-shirts...",2016-06-16 16:55:38,video,17,20,3,40
10513336322,"""There is this assumption that goes along with the 'born in the wrong body' narrative, that if you are a trans guy you would want a hysterectomy and never use your body to carry a pregnancy.""",2016-06-20 11:00:01,link,46,65,9,120
95926963131,Banjo the dog is keeping his rescuer happy and healthy! (via PEOPLE Pets),2016-06-18 23:00:13,link,115,93,4,212
10513336322,"""AND NOW WE SMITE THEM INTO TINY PIECES OF DUST AND DESTROY THEIR GOAL WITH A BALL SET ON FIRE BY OUR VOLCANIC THUNDER""",2016-06-15 10:00:00,link,128,67,50,245
25902406772,Showtime Shawn Porter is ready for his chance.,2016-06-23 14:35:03,link,175,96,42,313
10513336322,"""Since its battle with the FBI, Apple has made a number of important changes to increase security and tighten encryption. Apple itself couldn't decrypt information the agency demanded, but the company did have the keys to access information stored in the shooter's iCloud account. The company is now reportedly considering a system that wouldn't allow it to access iCloud data.""",2016-06-15 10:40:00,link,88,8,17,113
7245371700,"Aww, so glad they kept the OG Nemo in this way.",2016-06-20 09:18:57,link,200,67,16,283
10606591490,Game of Thrones just got better.,2016-06-19 21:30:17,link,9,66,49,124
75932763901,There were A LOT of tears 🌹,2016-06-20 21:30:00,link,70,77,49,196
13652355666,"The ruling, Clinton tweeted, ""could tear apart 5 million families facing deportation. We must do better.""",2016-06-23 11:08:10,link,184,90,11,285
112638779551,Bingo Smith was selected in the expansion draft and was a Cleveland Cavaliers original. Decades later he savors Sunday's NBA championship.,2016-06-20 15:40:59,link,139,63,39,241
7245371700,"Hey, girl!",2016-06-22 07:44:20,link,125,7,3,135
7245371700,I've always been wondering about this.,2016-06-19 02:10:27,link,133,90,28,251
7245371700,Today would've been Tupac's 45th birthday.,2016-06-16 11:33:04,link,188,19,18,225
75932763901,"""When this relationship first started you knew what it was and even participated in threesomes."" YIKES! See which bitter guy put his ex on blast and revealed they had multiple threesomes! –> http://bit.ly/1Q5y234",2016-06-18 14:45:00,photo,187,59,27,273
112638779551,The San Francisco Giants reportedly are 'open-minded' about Madison Bumgarner competing in the Home Run Derby.,2016-06-23 08:57:25,link,143,6,18,167
86680728811,"The Riviera Hotel and Casino - the Las Vegas Strip's first high-rise - exited the scene with a cinematic implosion, complete with fireworks. http://abcn.ws/261Ewnz",2016-06-15 01:12:16,video,130,20,8,158
112638779551,"This, even as Russia has ramped up its campaign for its banned track and field team to be allowed to compete at the Rio 2016 Olympics.",2016-06-15 16:48:29,link,129,70,16,215
112638779551,#Betcha didn't know the first person to order an Arnold palmer wasn't Arnold Palmer.,2016-06-15 12:15:39,video,18,89,15,122
112638779551,"""One of the things that the St. Louis Cardinals have always believed in is giving people a second chance."" — St. Louis Cardinals GM John Mozeliak",2016-06-17 21:02:29,link,18,85,1,104
95926963131,"Not only is Beyoncé a talented singer, but it turns out she's a prankster too!",2016-06-18 09:00:19,link,78,27,25,130
52150999700,Dwayne The Rock Johnson and Kevin Hart are a winning comedic duo in Central Intelligence.,2016-06-16 18:40:00,link,120,76,2,198
5281959998,The myth of the cool and steady shooter is one of the most cherished beliefs of the National Rifle Association and its supporters. Read on in The New York Times Opinion Section.,2016-06-16 08:55:00,link,167,73,38,278
86680728811,"U.S. Navy veteran who parked in spot marked for veterans surprised by note waiting for her when she returned. ""This parking is for Veterans, lady. Learn to read and have some respect.""",2016-06-15 06:28:00,link,14,80,37,131
95926963131,Hoover the tiger finally knows the feeling of grass between his paw pads. (via PEOPLE Pets),2016-06-18 11:20:04,link,60,33,18,111
112638779551,"The Derrick Rose trade means absolutely nothing for the NY Knicks...

...for now

Rob Perez: http://www.foxsports.com/nba/story/the-derrick-rose-trade-means-nothing-for-the-knicks-for-now-062216",2016-06-22 18:53:18,link,132,88,44,264
10513336322,Pinchas Gutter survived a Nazi death camp – and now his story will live on through a hologram that can answer your questions.,2016-06-18 07:20:01,link,56,3,4,63
112638779551,"The Copa América Centenario final is set! 

It's Argentina vs Chile this Sunday, 4pm ET on FS1. #Copa100",2016-06-22 23:19:27,photo,162,39,44,245
7245371700,"Now that Justin Bieber's cut his hair, where does he fit in to the history of pop stars' swooshy hairstyles?",2016-06-21 13:22:56,link,104,87,23,214
75932763901,These abuse allegations against Kate Gosselin are seriously terrifying –>http://bit.ly/211Orql,2016-06-19 02:30:00,photo,47,61,32,140
112638779551,"For the first time in nearly two years, Rory McIlroy is outside the top three in the world.",2016-06-20 13:09:45,link,86,58,23,167
5281959998,"Russia's entire track team, even athletes without past drug violations, risks being banned from the Olympics.",2016-06-17 07:25:00,link,166,87,43,296
75932763901,WARDROBE MALFUNCTION: Kendall Jenner put her nipples on display in see-through shirt — and you can see EVERYTHING! —> http://bit.ly/28NT2rB,2016-06-22 12:30:00,photo,111,53,15,179
18807449704,Donald J. Trump just got shut down by Lily Allen on Twitter,2016-06-24 05:59:59,link,140,19,30,189
52150999700,Our favorite FRIENDS (TV Show) characters have impressive pasts. 🙌🏻,2016-06-18 19:01:00,link,8,7,35,50
112638779551,It's all happening tonight. Clay Travis is going to be a busy man.,2016-06-19 13:31:13,video,141,36,12,189
95926963131,Katie Holmes' daughter Suri is growing up so fast! (via People Babies),2016-06-18 12:20:08,link,18,52,20,90
75932763901,CHEATER! The truth FINALLY comes out about Calvin Harris and Taylor Swift's relationship — and it's going to get ugly! —> http://bit.ly/1UAh50H,2016-06-17 18:00:00,photo,67,98,41,206
10513336322,Car dealer Mike Hagan says the possibility the weapons he's giving away could be used to kill civilians doesn't weigh on him.,2016-06-18 12:20:00,link,47,83,1,131
52150999700,🌟🌟 RuPaul's Drag Race is full of all-stars! 🌟🌟,2016-06-17 09:08:04,link,10,57,18,85
52150999700,There's no doubt Finding Nemo is one of the greatest Disney Pixar movies ever made. 🐟  (via FanSided),2016-06-17 02:25:00,link,75,35,27,137
10606591490,"""We barely got a chance to congratulate each other on the magical feat we'd accomplished with making this child.""",2016-06-17 18:00:16,link,196,2,26,224
95926963131,Driving fancy cars is what really gets Scott Disick's motor running—not his ex's sisters.,2016-06-16 15:27:04,link,48,84,24,156
95926963131,"""There is this gigantic hole in my heart that I know is never going to go away,"" Christina Grimmie's father said.",2016-06-17 22:46:06,link,21,27,17,65
10513336322,"""In the last eight years, I have, almost literally, eaten my way around Britain for the Guardian. I have written around 80 instalments of its best budget eats series and visited over 1,000 establishments from Edinburgh to Exeter. Here are my pointers on how to dine memorably at low prices and my choice of Britain's 10 best budget cafes, restaurants and diners.""",2016-06-16 04:00:00,link,72,82,8,162
112638779551,What's faster: A golf ball or a #LexusRCF? - Lexus Greatest Drive Challenge.,2016-06-18 07:31:23,video,61,53,33,147
10513336322,Some voters in Britain's EU referendum were convinced the use of pencils at polling stations was a ploy to secretly alter their ballots.,2016-06-23 18:00:00,link,193,94,38,325
75932763901,OMG! This is one of the first pics of Saint West – just wait until you see how adorable he is in the most recent snap! –> http://bit.ly/1UQwCbg,2016-06-16 20:00:00,photo,125,84,40,249
75932763901,Those eyes... 😍  Do you think he looks more like Kanye or Kim Kardashian West?,2016-06-24 09:00:01,link,177,6,29,212
5281959998,"Rachel Maddow, Andy Cohen and others recall what gay bars meant to them as they began to embrace their sexuality.",2016-06-22 17:55:31,link,197,50,34,281
5281959998,"""I've seen topes that were built, I'm convinced, just to make drivers slow down for vendors who sell candy and water.""",2016-06-15 11:55:00,link,80,92,18,190
18807449704,EVIL!,2016-06-23 16:46:08,link,170,43,20,233
112638779551,"From tee to green, Lexus has you covered. Watch FOX Sports LIVE in Virtual Reality using the NextVR app now!",2016-06-19 10:30:44,link,125,48,33,206
75932763901,Lamar Odom finally breaks his silence about his rocky relationship with Khloé Kardashian— and it's not what we expected to hear! —> http://bit.ly/28K8eIy,2016-06-20 17:00:00,photo,27,63,33,123
25902406772,This is awesome stuff.,2016-06-19 11:02:04,link,28,5,13,46
10606591490,"The assailant is reported to have shouted ""Britain first"" during the attack.",2016-06-16 13:30:08,link,144,71,46,261
13652355666,"""It looked like time had stopped.""",2016-06-17 07:34:00,link,25,24,33,82
112638779551,"""I have strong belief that if I play Game 5, we win."" Draymond Green #NBAFinals",2016-06-15 18:19:20,video,171,48,35,254
86680728811,"LeBron James, Stephen Curry prepare for dramatic NBA Finals Game 7 showdown: http://abcn.ws/21u0FHZ",2016-06-19 16:36:26,link,200,53,6,259
5281959998,"There is ""no question"" that the 2-year-old dragged away by an alligator at a Disney resort is dead, a police sheriff said.",2016-06-15 13:10:05,link,102,57,40,199
86680728811,"Omar Mateen bought nearly $9,000 worth of jewelry less than a week before he killed 49 people at the Pulse nightclub in Orlando, Florida,",2016-06-20 00:11:16,link,97,2,39,138
75932763901,CONGRATS! 'Little Women: LA' Star Briana Renee gave birth to baby No. 2! And it's a... Click here to find out —> http://bit.ly/28RXoxf,2016-06-24 10:00:00,photo,48,95,15,158
13652355666,Uber and Lyft drivers in Chicago are awaiting a vote next week that could force them to comply with many of the same kinds of regulations city-licensed taxis must meet.,2016-06-19 00:35:04,link,83,85,24,192
10513336322,"A study conducted by Mencap this year found that one in three young people with a learning disability spent less than an hour outside their home on a typical Saturday. Respondents listed fears including bullying, being laughed at and getting lost as being key concerns when leaving the house. As a result, it can be difficult to build relationships with others. To celebrate Learning Disability Week, here are 11 stories of people who have found love and friendship through charity programmes.",2016-06-20 11:20:00,link,9,25,11,45
112638779551,"You might play in the U.S. Open one day. These people? Probably not. 

via @TheBuzzer",2016-06-18 10:07:34,video,143,63,17,223
5281959998,Brexit would bring about a lengthy political and legal mess.,2016-06-22 03:58:30,link,139,58,22,219
18807449704,"""The sweetest, most humble, delightful, talented guy you'd ever meet.""",2016-06-19 13:42:02,link,4,38,4,46
13652355666,This is a skill that is taught.,2016-06-18 20:30:00,link,179,34,10,223
112638779551,"Three-time U.S. Open champion Tiger Woods congratulates Dustin Johnson on ""overcoming that rules farce.""",2016-06-19 20:41:47,link,97,24,49,170
75932763901,SO HUMILIATING!! See which celeb's untimely accident was captured on camera! (via Life & Style Weekly) —> http://bit.ly/28Te1LS,2016-06-23 14:00:00,photo,24,31,41,96
52150999700,This is a super sweet gesture from the former Doctor Who star. ❤️,2016-06-20 18:05:00,link,15,33,3,51
52150999700,Lin-Manuel Miranda is helping Florida's LGBT community in any way he can.,2016-06-16 13:04:00,link,153,97,34,284
52150999700,"Legendary rapper Tupac would've celebrated his 45th birthday today. Gone, but never forgotten.",2016-06-16 20:52:00,link,102,81,38,221
25902406772,It really doesn't get any better.,2016-06-16 22:50:11,photo,99,33,14,146
86680728811,"Oakland, California, lost its third police chief in nine days Friday as the city's embattled police force grapples with allegations of sexual misconduct. http://abcn.ws/1UEnTu6",2016-06-19 13:44:47,link,177,41,9,227
18807449704,Someone predicted Taylor Swift and Tom Hiddleston a long time ago?! But how?!,2016-06-16 14:26:26,link,135,76,29,240
112638779551,"President Obama tells Ty Lue to make sure J.R. Smith has a shirt on when the Cavs visit The White House

http://www.foxsports.com/nba/story/watch-president-obama-congratulate-ty-lue-tell-j-r-smith-to-put-shirt-on-062316",2016-06-23 23:12:02,link,137,63,40,240
52150999700,Everything is NOT awesome for The LEGO Movie fans.,2016-06-17 22:21:34,link,127,14,25,166
25902406772,The Tampa Bay Rays are honoring the Orlando victims.,2016-06-17 17:09:04,link,147,33,10,190
25902406772,Drew Brees' sons aren't New Orleans Saints fans.,2016-06-19 14:48:02,link,142,48,14,204
13652355666,What will the fallout be?,2016-06-24 00:47:20,link,111,29,28,168
86680728811,"JUST IN: Body of 2-year-old boy dragged into water by alligator has been recovered, Orange Co. Sheriff says. http://abcn.ws/1Yr4EFD",2016-06-15 15:38:39,video,127,88,25,240
13652355666,UPDATE: azcentral got its answer. How hot is it? Too hot for the live stream. The phone overheated and turned off midway through.,2016-06-20 15:08:46,video,147,10,11,168
5281959998,A subset of American babies fall behind with their first bottle. (via The New York Times Opinion Section),2016-06-16 03:25:00,link,32,41,27,100
5281959998,"As play continues for Slovakia vs. England and Russia vs. Wales, follow real-time updates on how teams can advance to the UEFA EURO knockout round.",2016-06-20 15:03:28,link,189,40,12,241
7245371700,Bella Thorne takes you ~behind~ the scenes.,2016-06-17 02:58:31,link,171,79,10,260
5281959998,"Reinhold Hanning was sentenced to 5 years as an accessory to at least 170,000 deaths. He may be the last former Nazi sentenced for war crimes.",2016-06-20 01:55:00,link,123,53,34,210
25902406772,Harold Lederman is now in the Hall of Fame.,2016-06-15 12:00:19,link,151,71,49,271
10606591490,Legendary.,2016-06-15 07:01:01,link,118,91,22,231
112638779551,"#Betcha don't know how México star Jesús ""Tecatito"" Corona got his nickname! #ElTri",2016-06-20 13:10:34,video,36,2,24,62
5281959998,Looking for a dead medieval king? You might want to check under a parking lot.,2016-06-15 01:55:00,link,125,59,34,218
52150999700,Steven Spielberg has confirmed: the West Side Story rumors are officially true!!! 😱,2016-06-16 16:22:00,link,41,14,43,98
52150999700,"The power of makeup is INCREDIBLE, Finding Nemo fans! 👌🏼",2016-06-15 17:48:00,link,51,79,38,168
10606591490,He will begin serving a sentence for sexually abusing at least four boys.,2016-06-21 08:00:58,link,172,78,3,253
5281959998,"She used an app. Within 3 days, her birth control pills arrived.",2016-06-19 09:35:00,link,77,72,45,194
25902406772,The Chicago Cubs get a little younger.,2016-06-16 12:32:29,link,132,84,47,263
112638779551,"How do future NBA stars spend their last few days before the draft? 

We spoke with Duke Basketball's Brandon Ingram, Kris Dunn and others, just days before their lives are set to change forever....",2016-06-21 08:09:23,link,106,96,29,231
13652355666,Interfering with firefighters is a federal offense.,2016-06-21 14:25:00,link,126,1,18,145
75932763901,POOR AUBREE! Teen Mom 2 star Chelsea Houska's six-year-old daughter is going to be heartbroken after hearing her father did THIS —> http://bit.ly/28Ns59y,2016-06-22 11:00:00,photo,146,22,25,193
10606591490,"The southern Indian state is on ""high alert.""",2016-06-15 04:00:17,link,96,14,36,146
7245371700,The Juicy renaissance is upon us.,2016-06-19 07:06:42,link,177,69,31,277
5281959998,"A line that neatly encapsulates the nature of this season of ""Outlander"": ""The truth is often vexing.""",2016-06-19 21:40:01,link,106,58,20,184
86680728811,"When Scott Dunn woke up from coma he'd been in since getting into a car accident, he was heartbroken to realize he'd missed his high school graduation. So his classmates gave him a do-over.",2016-06-17 06:28:05,link,68,62,44,174
112638779551,U.S. Open Championship Weather Update.,2016-06-16 15:47:26,video,200,47,50,297
13652355666,"Although demand for abortion pills has been especially high in Brazil, women in this country are often unable to receive them.",2016-06-23 00:22:00,link,162,82,2,246
52150999700,Jennifer Aniston and Ty Burrell are the COOLEST parents around in Storks Movie! 👌🏼,2016-06-15 13:33:00,link,163,31,2,196
25902406772,Not a bad problem for Mrs. Ross to have.,2016-06-18 13:56:03,photo,6,91,5,102
86680728811,"Senate voted down four gun control measures, with Republicans and Democrats largely divided along party lines.",2016-06-20 21:00:50,link,22,82,27,131
13652355666,"When Stacey Feeley found out why her 3-year-old was standing on a toilet, her heart broke. http://usat.ly/28SjGUe",2016-06-23 18:28:00,video,182,40,37,259
75932763901,"""It's not the key to a happy marriage!"" See which actress just made this shocking confession about her sex life (via Closer Weekly) —> http://bit.ly/1Y2ZAYm",2016-06-22 06:45:00,photo,173,19,8,200
13652355666,"At one point, Seddique Mateen had even announced his candidacy for president of Afghanistan.",2016-06-16 05:33:11,link,174,9,20,203
5281959998,"The protest was billed as a memorial for a 20-year-old woman who was found dead last month. A U.S. Marine veteran who was working as a civilian contractor on the island has been arrested in connection with the killing, prompting a public outcry.",2016-06-19 04:45:09,link,6,53,40,99
7245371700,"Laugh all you want, but this documentary seems to have a lot of terrifying twists and turns...",2016-06-16 19:48:42,link,95,13,42,150
86680728811,"United Nations says just over 65 million people were displaced worldwide by the end of last year, easily setting a new postwar record.",2016-06-20 07:15:52,link,138,34,10,182
10513336322,"""If British voters decide to leave, the odds of an EU collapsing amid anti-immigrant acrimony will increase.""",2016-06-23 02:00:00,link,58,60,41,159
112638779551,"Klay Thompson looks ahead to Game 7: ""We're a deeper team.""

Who do you like in Game 7?  #NBAFinals",2016-06-16 23:57:10,video,44,24,11,79
52150999700,Led Zeppelin Official's 45-year-old classic is under fire for serious copyright issues.,2016-06-16 16:02:01,link,15,57,48,120
95926963131,"Ariel Winter is sick and tired of body shamers, and she's firing back.",2016-06-23 10:36:04,link,42,86,2,130
25902406772,"This sounds like a blockbuster, but really, it's just a calculated move for both sides.",2016-06-22 17:20:47,link,14,57,1,72
86680728811,"""I used to be jealous of all my friends who were close with their fathers growing up. For years, I watched and was invited to baseball games, dinners and even high school sporting events as my buddies all leaned on their dads for friendship and support. I never had that.""",2016-06-19 19:58:03,link,177,79,32,288
95926963131,Chelsy Davy opens up about her lasting friendship with ex Prince Harry.,2016-06-20 10:40:02,link,5,95,35,135
5281959998,"Iraqi forces liberating Falluja are finding beheaded bodies, apocalyptic streetscapes and clumps of hair from fighters who shaved to blend in with fleeing civilians.",2016-06-22 23:25:00,link,79,46,45,170
5281959998,Roy Cohn was once New York's most feared lawyer. But there was one client who occupied a special place in his famously cold heart: Donald J. Trump.,2016-06-20 11:55:00,link,118,61,14,193
86680728811,"Marco Rubio said this week that the mass shooting in his home state had driven him to reconsider ""everything that's going on,"" including whether or not he should stay in the Senate. http://abcn.ws/1XZOapH",2016-06-17 15:49:07,link,76,47,4,127
112638779551,Who says Oakmont Country Club is tough? Sergio Garcia makes it look easy. #LexusRCF #USOpen,2016-06-17 13:36:23,video,41,9,14,64
112638779551,US men's national soccer team star Michael Bradley paid tribute to the victims of the Orlando tragedy. Bravo!,2016-06-17 11:12:15,link,115,12,1,128
5281959998,"With the finale next week, ""Silicon Valley"" leaves the gang once again on the brink of disaster, which by now is a familiar place for them to be.",2016-06-19 22:55:00,link,20,18,22,60
75932763901,"This may look like one of the (seemingly) hundreds of selfies Kylie Jenner takes in a day. But when you see what the caption, you'll understand why fans are FREAKING OUT —> http://bit.ly/1W3LRQs",2016-06-17 12:02:49,photo,180,69,25,274
112638779551,"Best scanner sound: Tony Stewart was having fun at Michigan International Speedway, at his crew chief's expense. #NASCAR",2016-06-15 15:02:05,link,132,67,28,227
52150999700,"So THAT'S what happened to Dr. Okun, Independence Day fans! 😱",2016-06-19 14:35:39,link,78,5,14,97
25902406772,A Cleveland legend says LeBron James' Finals performance should be immortalized.,2016-06-21 11:52:25,photo,64,56,18,138
75932763901,WOW! This sexy 21-year-old is dating a famous 39-year-old father —> http://bit.ly/28WE5rc,2016-06-24 19:00:00,photo,108,27,47,182
7245371700,"Well, I learned a new useful acronym.",2016-06-16 00:43:24,link,111,17,29,157
95926963131,Watch a People staffer jump into shark infested waters with  Discovery channel's Shark After Dark host Eli Roth just in time for Shark Week!,2016-06-23 16:50:00,video,64,30,12,106
25902406772,Ever want to name a professional sports team??,2016-06-20 19:16:32,link,118,81,46,245
18807449704,This is a huge step forward for Barbie.,2016-06-16 10:55:55,link,123,23,2,148
86680728811,"When Philadelphia's new soda tax takes effect in 2017, a six-pack of 16-ounce bottles would go up $1.44, unless stores absorb the cost.",2016-06-16 19:03:46,link,25,33,19,77
7245371700,"Aww, it's hard to spread your wings in this big, big world.",2016-06-19 23:20:46,link,38,57,50,145
25902406772,"Outclassed and outpaced, Mexico struggled to defend Chile's talented attackers.",2016-06-18 22:52:17,link,1,38,36,75
112638779551,The Carolina Panthers have rewarded Michael Oher for protecting Cam Newton's blind side.,2016-06-17 08:18:43,link,163,57,19,239
86680728811,"At a press conference in Orlando, U.S. Attorney Lee Bentley says it's ""premature"" to speculate about possible charges following Orlando mass shooting investigation abcn.ws/1U9OLOY",2016-06-15 12:58:35,video,154,90,26,270
7245371700,This new shade is ~majestic~.,2016-06-16 02:03:53,link,87,26,37,150
5281959998,Sweden was once one of the most welcoming countries for refugees. Now that's changing.,2016-06-21 23:25:01,link,52,34,37,123
10606591490,Watch this man's tactic.,2016-06-20 23:00:44,link,21,9,34,64
10513336322,"""The old plastic Tardis style is gone. Toilets have always been a massive talking point, and no one ever talks about toilets in everyone's day-to-day life, but as soon as they get to a festival that's all they want to discuss.""",2016-06-19 10:20:01,link,81,10,9,100
86680728811,"JUST IN: Body of 2-year-old boy dragged into water by alligator at Disney World resort has been recovered, officials say. http://abcn.ws/1rqB5XN",2016-06-15 15:36:42,link,186,6,15,207
25902406772,Plenty to break down in Group B.,2016-06-20 17:33:02,link,45,99,3,147
5281959998,"""After my dad died, a strange thing happened. My brothers began to call me just to check in.""",2016-06-17 09:55:01,link,78,47,15,140
7245371700,Maybe Zayn will rethink that studio time w/Tyler the Creator?,2016-06-21 18:02:52,link,145,2,33,180
95926963131,"Just one day after news of her divorce broke, tension between Jules Wainstein and her husband Michael is escalating.",2016-06-16 15:49:03,link,55,1,50,106
7245371700,Plays With Squirrels from Boy Meets World is wiser than ever.,2016-06-16 20:25:16,link,45,31,20,96
75932763901,"""He was 16 and I was 23. It was before he got real heavy with Britney."" We had NO IDEA that Justin Timberlake was linked to this very famous MUCH older woman when he was just a teen! –> http://bit.ly/201UGt9",2016-06-24 20:00:00,photo,116,12,2,130
112638779551,Pavel Datsyuk makes it official: He is leaving the Detroit Red Wings to return to Russia.,2016-06-18 11:53:36,link,66,6,10,82
13652355666,"""I expect you will sleep,'' Comey advised. ""And I want you to love somebody.''",2016-06-19 18:13:01,link,178,19,15,212
112638779551,LeBron James quoted JAY Z after winning a championship with the Cleveland Cavaliers,2016-06-19 23:43:21,video,78,8,14,100
52150999700,Game of Thrones' Iwan Rheon speaks out about last night's seriously epic episode.,2016-06-20 07:58:44,link,62,41,48,151
7245371700,"As much as I would LOVE to sing ""Wannabe"" at a The Spice Girls reunion show, here's why we should probably all give up on this idea...",2016-06-17 15:59:56,link,149,97,5,251
18807449704,"Laverne Cox: ""The hardest thing [about filming] was knowing that this was real and there was a responsibility that was bigger than me.""",2016-06-19 17:02:01,link,115,26,12,153
13652355666,"Gordie Howe (right), aka Mr. Hockey, will be eulogized today.

More things to know: http://usat.ly/1UU59CL",2016-06-15 06:12:42,photo,112,8,16,136
7245371700,"""It's hard to find fault with the film's ultimate message, that even impossible-seeming problems can be eased if we accept and work with them, an optimism that will vibrate through audiences struggling with challenges from anxiety to dyslexia.""",2016-06-15 11:35:08,link,182,38,7,227
112638779551,Former Cleveland Browns QB Johnny Manziel had some more trouble earlier this week.,2016-06-22 12:54:14,link,83,34,18,135
25902406772,Cleveland is going to cherish this championship and it's well deserved.,2016-06-20 09:23:34,link,14,97,49,160
7245371700,"Some people in Congress don't want Harriet Tubman on the $20 bill.  

Here's proof that she deserves to stay on put.",2016-06-22 11:30:43,link,175,24,25,224
10606591490,6. They teach their kids math early on.,2016-06-18 06:00:41,link,165,62,43,270
52150999700,"Shrek fans, we could be seeing more of Puss In Boots and the gang! 😍",2016-06-19 06:39:00,link,113,33,50,196
95926963131,This veteran's story will break your heart. (via PEOPLE Pets),2016-06-18 03:00:31,link,148,35,5,188
95926963131,Jamie Lynn Spears opens up about her life now ahead of her new TLC documentary.,2016-06-22 08:28:06,link,131,26,49,206
7245371700,Wiz Khalifa offers up some ~ relaxation ~ motivation for the people.,2016-06-22 18:23:07,link,169,74,2,245
10513336322,"Toys, prams, reporter's microphones ... it's all the same to Cristiano Ronaldo.",2016-06-22 05:50:00,link,16,62,26,104
86680728811,"One year ago today, Donald J. Trump came down the escalator inside Trump Tower and declared his candidacy for president. http://abcn.ws/1UBsB80",2016-06-16 16:12:35,video,54,63,32,149
18807449704,Introducing the condom of the future.,2016-06-21 14:55:54,video,114,91,13,218
52150999700,Some seriously famous faces have stopped by Pawnee on Parks and Recreation.,2016-06-18 23:02:00,link,111,80,35,226
18807449704,Confused about Brexit? Let Last Week Tonight with John Oliver break it down for you.,2016-06-24 09:55:58,link,52,62,40,154
52150999700,Dwayne The Rock Johnson knew Kevin Hart would be perfect for a hilarious reason. 😂,2016-06-17 12:52:00,link,23,89,30,142
52150999700,The Star Trek actor died in a car accident on Sunday morning.,2016-06-19 13:26:03,link,168,64,11,243
112638779551,Boston Red Sox icon David Ortiz says he wouldn't go public with his retirement announcement if he could do it over again.,2016-06-20 17:21:10,link,129,51,21,201
52150999700,The Hamilton: An American Musical cast will film everything in the room where it happens. 🙌🏻,2016-06-16 12:02:44,link,183,95,37,315
86680728811,Man arrested at a Donald J. Trump rally in Las Vegas told authorities he tried to grab an officer's gun so he could kill the candidate.,2016-06-20 16:20:54,link,86,24,40,150
25902406772,Neyland Stadium was home to one of Baker Mayfield's favorite games.,2016-06-23 16:36:17,link,126,12,2,140
112638779551,Daniel Bryan will come back as a commentator for the upcoming WWE Cruiserweight Classic.,2016-06-22 10:55:58,link,78,42,44,164
86680728811,"EMOTIONAL REUNION: Orlando shooting survivor Angel Colon reunites with police officer Omar Delgado, who courageously pulled him out of the nightclub to safety: ""I'm so glad you're alive."" http://abcn.ws/1YvDduB",2016-06-16 18:13:47,video,12,52,34,98
10513336322,"When storing digital photos, aim to have at least three copies of everything, preferably more.",2016-06-23 10:40:00,link,4,26,27,57
112638779551,"The Cleveland Cavaliers ended the drought, and Earnest Byner couldn't be happier.",2016-06-20 04:25:31,link,106,13,10,129
10606591490,Her lawyer said it would help her get a job.,2016-06-20 22:00:13,link,70,15,23,108
7245371700,"Who lives, who dies, who takes Winterfell on Game of Thrones?",2016-06-17 17:30:10,link,123,65,34,222
75932763901,"Shortly after confirming her divorce, Teen Mom 2's Kailyn Lowry shared more heartbreaking miscarriage news — and it'll absolutely break your heart —> http://bit.ly/28MIkoo",2016-06-21 12:00:00,photo,186,2,24,212
112638779551,Stephen Jones wasn't shy about addressing the worst area of the Dallas Cowboys' defense.,2016-06-16 12:47:34,link,32,58,7,97
95926963131,"""There is a time to be critical,"" the Massachusetts mom tells PEOPLE. ""But this is just not the time. It's heartbreaking.""",2016-06-16 20:16:04,link,123,70,26,219
86680728811,Today is a big day for Stephen Curry and LeBron James. And it has nothing to do with Game 7: http://abcn.ws/1UEfUx6,2016-06-19 14:15:17,link,6,93,2,101
112638779551,"Jordan Spieth has a lot of fans at the U.S. Open Championship, but Kentucky Wildcats coach John Calipari has a special reason to root for him. 

Kristen Balboni for @TheBuzzer",2016-06-16 17:35:03,video,7,33,22,62
13652355666,The kids at Starship Chidren's Hospital in New Zealand are all smiles. usat.ly/1UaGjiq,2016-06-16 17:35:00,video,114,20,12,146
86680728811,Starbucks says lawsuit claiming the coffee chain under-fills its lattes by 25% is 'without merit.',2016-06-22 04:30:26,link,62,69,13,144
10606591490,IQ is overrated.,2016-06-17 04:30:12,link,173,15,11,199
25902406772,Showtime Boxing is getting you hyped for Thurman-Porter.,2016-06-15 10:29:16,video,34,20,23,77
7245371700,Can't wait to watch the bands battle it out.,2016-06-18 17:02:04,link,66,29,11,106
112638779551,"The Chicago Cubs are going to be tempted to deal some young talent at the deadline, but the do-everything Javier Baez isn't going to be in that mix.",2016-06-20 08:10:14,link,196,20,18,234
18807449704,👏 👏 👏 John Cena,2016-06-17 08:30:00,link,63,64,45,172
5281959998,Israel devised a 400-mile wall to thwart attacks. Smugglers see a business opportunity.,2016-06-21 02:55:00,link,115,13,41,169
95926963131,"Kylie Jenner can cross yet another sexy music video off her bucket list—only this time, it wasn't with Tyga.",2016-06-23 15:22:24,link,80,44,33,157
13652355666,Hillary Clinton may get millennial women's vote in November.,2016-06-23 17:00:00,link,150,51,21,222
10606591490,A bucket list for book lovers.,2016-06-18 20:00:32,link,87,88,42,217
112638779551,A bat from New York Yankees legend Lou Gehrig sold for six figures at auction.,2016-06-22 12:55:55,link,177,8,10,195
52150999700,Meet the new heroes—and the galaxy's shrewd new villain—in '#RogueOne: A Star Wars Story.'  🙌🏻 😱,2016-06-22 10:44:40,link,110,74,19,203
25902406772,Looks like Kevin Love is going to need to set his DVR.,2016-06-19 14:15:44,link,170,97,41,308
52150999700,These Game of Thrones stars have come a long way.,2016-06-16 02:19:00,link,91,98,49,238
95926963131,There's another baby on the way for Ashton Kutcher and Mila Kunis! 💕 (via People Babies),2016-06-15 19:23:57,link,189,17,9,215
18807449704,Wait until you hear his Donald J. Trump impression! 😂,2016-06-16 14:00:00,link,9,52,10,71
86680728811,"Little girl who beat cancer twice in her young life is now all grown up, and she's returned to the same hospital where she was treated, this time as a nurse.",2016-06-15 04:30:00,link,128,44,21,193
25902406772,WHOA.,2016-06-23 20:10:38,link,49,64,21,134
25902406772,Which conference dominates the NBA  draft?,2016-06-15 14:18:27,link,113,52,47,212
75932763901,This famous wife got her man a prostitute for his birthday so that they could have a threesome! We would've never expected it from them! –> http://bit.ly/1XX8ZlR,2016-06-15 21:00:01,photo,5,73,16,94
10513336322,"""During a 12-step recovery program, I called every one of my creditors and told them that, not only was I an alcoholic, but that I couldn't afford to pay them back.""",2016-06-20 08:40:00,link,33,48,37,118
7245371700,Cruz isn't just as beatable as Trump — they both spell doom for the Republican Party.,2016-06-18 11:42:09,link,49,88,29,166
13652355666,U.S. travelers no longer have to cross the Atlantic for such forbidden pleasures.,2016-06-18 16:04:00,link,106,59,1,166
10513336322,"""Vote this week. Vote for a united country that reaches out to the world, and vote against a divided nation that turns inwards. Vote to remain.""",2016-06-20 12:00:00,link,165,31,21,217
7245371700,The supermodel queen has spoken.,2016-06-22 18:50:07,link,60,5,4,69
86680728811,"The massacre at the Pulse nightclub in Orlando left dozens dead or injured, families reeling and a nation in shock—but it also left a lasting emotional impact on the medical professionals who treated the victims: http://abcn.ws/25XqiHK",2016-06-15 09:40:00,link,184,100,9,293
95926963131,A Sandy Hook mom was surprised when Connecticut Sen. Chris Murphy chose to share her son's story on the Senate floor last Wednesday.,2016-06-20 14:23:00,link,78,45,46,169
112638779551,McIlroy was crushing Oakmont Saturday until he came to the third green.,2016-06-18 12:13:51,link,69,25,11,105
10513336322,"British people backing a leave vote in the EU referendum are almost twice as likely to believe that climate change does not have a human cause, according to a new poll.",2016-06-16 12:20:00,link,108,16,26,150
112638779551,Bautista hurt himself while chasing down a fly ball in Thursday night's win against the Phillies.,2016-06-17 15:36:34,link,146,79,28,253
95926963131,"How Joey Rott is raising 5 children after the unexpected death of his wife, Casi. (via People Video)",2016-06-15 20:06:08,video,143,22,32,197
13652355666,"If you see Muñoz as Hamilton instead, so did the Obamas.",2016-06-16 23:19:00,link,103,99,40,242
52150999700,Countess LuAnn de Lesseps has found a special someone. ❤️,2016-06-15 22:05:00,link,147,18,36,201
13652355666,"From the Dad Rock dudes, of course. (Yes, that's a vertical turntable.)",2016-06-18 06:14:00,link,34,92,21,147
10513336322,What's been your favourite television show this year? Have we missed any?,2016-06-15 12:30:00,link,47,48,44,139
25902406772,LeBron James doesn't want to lose.,2016-06-16 23:10:03,photo,76,33,14,123
75932763901,THE DIVORCE IS OFF?! Get the shocking update —> http://bit.ly/1Xq5Rhd,2016-06-16 06:00:00,photo,83,30,22,135
25902406772,It's an important offseason for the Chicago Bulls.,2016-06-15 14:45:05,link,73,3,38,114
10513336322,"Richard Osman: ""I hate this new tendency to think that anyone who disagrees with you is stupid or part of some conspiracy.""",2016-06-18 06:40:00,link,161,1,9,171
112638779551,LeBron James and the Cleveland Cavaliers need more from Kevin Love in Game 6 if they want to push the Golden State Warriors to a winner-take-all Game 7.,2016-06-15 19:07:48,link,198,9,38,245
112638779551,"If these two can't work it out, is love even real?!?!",2016-06-19 20:30:00,link,111,25,27,163
10606591490,She later deleted the tweet and apologized.,2016-06-17 09:12:27,link,118,80,25,223
52150999700,CBS is underfire from The Price Is Right legend himself.,2016-06-23 14:26:00,link,180,20,36,236
10513336322,"""Ours is a broken economic system, rigged in favour of a tiny elite whose fortunes more than doubled even as the wages of millions fell. It is an elite riddled with contempt for democracy, and will be damned if anybody wishes publicly to scrutinise its affairs. It is happy to treat the state as a cash cow but reluctant to pay taxes to contribute to its upkeep. It drips with machismo and arrogance, believing that rules exist for the little people. And if this system were to take human form, it would surely be Sir Philip Green.""",2016-06-16 02:20:00,link,97,80,26,203
52150999700,Ellen Pompeo got her start alongside Jake Gyllenhaal in 'Moonlight Mile.',2016-06-23 04:33:00,link,126,17,28,171
18807449704,Apple wasn't kidding when it said iOS 10 was full of helpful new features.,2016-06-16 09:40:36,link,65,32,20,117
95926963131,We're taking Andy Cohen's recent promise into our own hands.,2016-06-18 00:00:15,link,107,90,26,223
5281959998,"An American woman converted to Judaism with an Orthodox rabbi. When she tried to marry in Israel, her status as a Jew was rejected.",2016-06-23 17:55:00,link,175,28,9,212
25902406772,"Keith ""One Time"" Thurman tells his story.",2016-06-23 14:33:32,link,103,1,3,107
18807449704,This footage is intense.,2016-06-15 23:55:20,link,52,25,22,99
25902406772,Turns out Leo Messi jerseys are magical.,2016-06-16 09:28:56,link,9,28,48,85
10513336322,"""If Lena Dunham and Alec Baldwin can have hits in audio, it seems appropriate for Malcolm Gladwell – the king of nonfiction – to give it a go.""",2016-06-21 05:40:00,link,101,57,9,167
112638779551,Steve Kerr shares his message to the Golden State Warriors after they had their hearts ripped out in Game 7.,2016-06-20 11:07:49,link,92,13,13,118
25902406772,Pretty sure JR Smith hasn't worn a shirt since the Cleveland Cavaliers won... Rightfully so.,2016-06-22 11:34:25,photo,110,21,21,152
112638779551,#3Things you need to know from the #NASCAR Sprint Cup Series off-weekend.,2016-06-20 16:12:41,video,162,36,9,207
112638779551,"Tim Lynch spent his childhood hunting down the likes of Miguel Cabrera and Lorenzo Cain for autographs. Now, he's a New York Yankees prospect.",2016-06-16 06:22:13,link,157,1,50,208
95926963131,"Both deputies have been hospitalized, one in serious but stable condition. (via People True Crime)",2016-06-18 15:40:10,link,163,70,5,238
25902406772,How would Dirk Nowitzki look in a Golden State Warriors uniform??,2016-06-20 21:46:39,link,36,88,20,144
112638779551,Johnny Miller's final round 63 to win the 1973 U.S. Open Championship might be the greatest round in golf history. #LookAgain,2016-06-15 07:21:47,video,16,49,25,90
25902406772,YIKES. Nick Young and Iggy Azalea ended their engagement.,2016-06-20 15:58:45,link,32,56,46,134
13652355666,"James Clarke was reading a book, when he saw a friend of his teenage son scramble out of the surf.",2016-06-18 04:50:00,link,47,89,26,162
95926963131,Finding Dory is everything you could have wanted from a Finding Nemo sequel.,2016-06-17 07:22:05,link,190,80,38,308
7245371700,Fangirling over this Fanning's photo shoot.,2016-06-21 22:18:26,link,116,72,11,199
25902406772,Ever wonder what would happen if Golf and Rugby had a baby? No? Me either. But it's REAL.,2016-06-22 16:26:57,link,94,5,44,143
25902406772,"""Derrick Rose bid farewell to his teammates, looked fondly out at the Windy City, then landed in the Big Apple.""",2016-06-22 18:34:51,photo,32,40,37,109
112638779551,The New York Mets manager really didn't like being goaded into a statement about Noah Syndergaard's elbow.,2016-06-23 08:06:12,link,164,71,30,265
25902406772,"Dustin Johnson got his summer of 2016 off on the right foot, here's a look at what comes next.",2016-06-20 12:54:21,link,44,31,35,110
75932763901,REUNITED?! See what Tyga just revealed about his relationship with Kylie Jenner —> http://bit.ly/1UGzOno,2016-06-18 13:45:00,photo,19,42,7,68
18807449704,"No, we're not crying, YOU'RE crying. 😭",2016-06-23 12:00:31,link,200,100,42,342
86680728811,"JUST IN: The United States Department of Justice and the FBI – Federal Bureau of Investigation reverse course and release the full transcript from Orlando shooter's 911 call to provide the ""highest level of transparency."" abcn.ws/28It1Ld",2016-06-20 14:03:58,photo,159,71,19,249
10606591490,You're not going to want fries with this.,2016-06-20 04:30:05,link,34,35,14,83
52150999700,We're live with Amber Rose talking about her new VH1 series!,2016-06-16 11:26:40,video,74,93,4,171
112638779551,#Deloitte brings you the sights and sounds of a Bryson DeChambeau practice round. #LookAgain,2016-06-15 11:24:11,video,72,88,3,163
10606591490,What's the secret to living to 100?,2016-06-20 00:00:32,link,63,4,9,76
25902406772,Bad news for Toronto Blue Jays fans.,2016-06-17 18:11:03,link,116,62,46,224
7245371700,There are no limits for Kanye West.,2016-06-22 22:14:41,link,131,15,45,191
95926963131,Five-year-old Julianna Snow's funeral was a perfect glitter-filled farewell. (via HelloGiggles),2016-06-24 02:00:55,link,16,30,20,66
25902406772,"Kicking them while they are down -- way, way down",2016-06-18 23:54:46,link,194,25,40,259
52150999700,Penny Dreadful's season 3 finale went out with a bang—and a whimper. 💥 💥 💥,2016-06-19 22:19:01,link,121,19,11,151
112638779551,Official Michael Bisping vs. Georges St-Pierre??? The UFC middleweight champ is definitely interested.,2016-06-20 11:57:42,link,123,78,43,244
86680728811,"JUST IN: Cleveland Cavaliers win Game 6 over the Golden State Warriors 115-101 to even the NBA Finals at 3-3, forcing a Game 7 on Sunday night. http://abcn.ws/1US2tIu",2016-06-16 22:46:22,photo,90,5,45,140
52150999700,Han stands out for being effortlessly cool in the Fast & Furious franchise. 👌🏼,2016-06-16 08:22:00,link,142,74,7,223
95926963131,A California teen has been charged in connection with the deadly beating and torture of a San Diego homeless man. (via People True Crime),2016-06-22 18:01:39,link,179,17,4,200
10513336322,"Bernie Sanders: ""The major political task that we face in the next five months is to make certain that Donald J. Trump is defeated and defeated badly.""",2016-06-17 03:40:01,link,28,81,29,138
95926963131,Gwen Stefani is one fun mom and aunt! (via People Babies),2016-06-16 18:25:59,link,3,16,49,68
75932763901,She is dating a newly single father-of-one – and his famous ex is NOT going to be pleased with THESE over-the-top pics –> http://bit.ly/1U48bGO,2016-06-23 21:00:01,photo,94,24,34,152
10513336322,"""No one seems to acknowledge that incessant gigging of the type that's now forced on modern musicians isn't always an undiluted artistic joy, but potentially exhausting and disastrous.""",2016-06-19 14:00:00,link,104,2,13,119
13652355666,Let's make it a good one.,2016-06-20 07:49:00,photo,164,25,6,195
95926963131,Photographer Tyler Shields recounts lively dinner with Yelchin three days before the actor's tragic death.,2016-06-21 22:30:20,link,33,95,28,156
75932763901,Reese Witherspoon's daughter Ava is all grown up — and looks JUST LIKE her famous mom! Wait until you see her now (via Closer Weekly) —> http://bit.ly/1QJhIQb,2016-06-18 19:30:00,photo,84,19,11,114
5281959998,"""She's not my wife, but I don't have a wife anymore and I need someone to take care of me,"" one of her clients said.",2016-06-16 14:25:00,link,5,52,10,67
112638779551,He says he has no interest in settling a federal lawsuit filed against him and the university by a woman who was raped by a football player.,2016-06-16 12:25:30,link,40,55,1,96
5281959998,Breaking News: More than 50 U.S. diplomats have signed a memo criticizing President Obama's Syria policy and urging strikes on the Assad government.,2016-06-16 19:45:10,link,39,4,50,93
95926963131,Who doesn't love a good Britney Spears and Jamie Lynn Spears throwback?,2016-06-23 21:36:05,link,156,51,38,245
25902406772,Your one-stop shop for all things NHL Free Agency.,2016-06-21 13:51:31,link,187,34,16,237
112638779551,New York Jets head coach Todd Bowles has the need for speed.,2016-06-21 11:28:54,link,134,78,41,253
52150999700,The Lion King made us all feel the love (tonight). ❤️,2016-06-19 05:11:00,link,186,43,24,253
112638779551,"Counting is hard, especially when you're already behind by nine runs. Just ask Philadelphia Phillies CF Odubel Herrera.",2016-06-17 07:03:28,link,92,66,37,195
75932763901,#MOOD. Share with a friend who gets it!,2016-06-23 09:30:00,photo,81,75,27,183
112638779551,Conor McGregor makes a lot of money and he spends it on the people he cares about the most.,2016-06-20 14:52:07,link,139,10,8,157
5281959998,The most high-profile critics of high-frequency trading have won approval for a new stock exchange.,2016-06-17 19:40:00,link,125,42,32,199
13652355666,It is a potentially epochal event that could change the face not only of the United Kingdom but of Europe.,2016-06-24 01:00:48,link,14,85,20,119
95926963131,A Connecticut mom is thanking people who rushed to defend her after a man started cursing at her for breastfeeding.,2016-06-15 10:40:09,link,29,47,38,114
10513336322,"""Win or lose on Thursday, Cameron isn't finished and he still looks the classiest player on the field, albeit in a pretty low-grade match of the kind angry England football fans know only too well.""",2016-06-17 01:00:00,link,85,69,3,157
86680728811,Documents reveal the Orlando shooting suspect wrote that he had a background in law enforcement working as a correctional officer trainee and security officer in 2006 and 2007. He also said that he applied to become a Florida state trooper in 2011. http://abcn.ws/1XrmlFU,2016-06-16 09:15:15,link,188,82,3,273
112638779551,"The Phoenix Suns went big with the No. 4 pick, taking Dragan Bender.",2016-06-23 19:30:30,link,69,30,29,128
95926963131,Selma Blair has issued an apology for her airplane outburst.,2016-06-21 18:36:06,link,75,30,1,106
18807449704,Carbon dioxide levels are now entering uncharted territory for humanity.,2016-06-17 19:34:30,link,105,87,22,214
112638779551,"A baseball team pulls off the water bottle flip trick during a weather delay.

Kristen Balboni for @TheBuzzer",2016-06-15 12:55:47,video,122,53,41,216
10513336322,"""In the same way that an unusually low tide occasionally reveals an ancient henge, the referendum campaign has exposed a chasm in British politics. Now the politicians who did so much to exacerbate the divide have to heal it. They have to find the language and the policies to rebuild the sense of solidarity that the past weeks have done so much to fracture.""",2016-06-23 17:20:00,link,145,20,2,167
5281959998,"Donald J. Trump has ""written a lot of books about business. They all seem to end at Chapter 11,"" Hillary Clinton said.",2016-06-21 18:55:00,link,188,24,16,228
112638779551,"The Minnesota Vikings played an absolutely ruthless prank on rookie Laquon Treadwell Wednesday.

You've got to see what they did to the former Ole Miss Football star...",2016-06-15 15:49:54,link,53,30,17,100
95926963131,What to eat for dinner is a nightly headache for this Utah family.,2016-06-21 15:13:32,link,44,16,22,82
112638779551,"If you're at Steve Smith's camp, don't cheer for the New England Patriots.",2016-06-23 09:35:21,link,27,1,2,30
18807449704,The Internet has done its duty: Tears of joy LeBron James.,2016-06-20 18:30:00,link,24,49,32,105
112638779551,Stephen Curry responds to criticism of his performances so far on the biggest stage. #NBAFinals,2016-06-15 18:04:42,video,20,54,3,77
52150999700,"The Mighty Kacy is finally BACK, American Ninja Warrior fans! 👊🏼",2016-06-20 16:14:01,link,34,66,12,112
95926963131,A modern day Romeo and Juliet! (via PEOPLE Pets),2016-06-19 04:00:17,link,68,23,23,114
10513336322,"""While the internet may be allowing itself a brief, maidenly flush of excitement at the pictures, nobody is groaning, 'Oh, put it away, To-Hid' or sniping, 'What an air head, how is this news?'""",2016-06-23 06:20:01,link,199,3,44,246
10606591490,How does your state compare?,2016-06-17 01:30:16,link,195,59,27,281
18807449704,Dufaycolor was ultimately surpassed by Kodachrome and other superior color processes.,2016-06-23 00:08:41,link,37,54,16,107
5281959998,A trove of letters sheds new light on President Obama's father. But the president has yet to read them.,2016-06-18 10:08:19,link,161,36,26,223
25902406772,Summer Sanders and David Shaw reunite at their old stomping grounds to chat about their time at Stanford University and his career as a coach.,2016-06-21 19:34:21,video,189,25,9,223
52150999700,We're live with the stars of Suits on the red carpet! #SuitsPremiereEvent,2016-06-23 17:36:00,video,189,68,41,298
25902406772,BUSTED!,2016-06-22 12:41:34,link,114,49,30,193
25902406772,If college football had a NBA type logo... How would it look? Hmmm..,2016-06-22 15:10:36,link,23,29,38,90
5281959998,The average death toll in terror attacks is close to zero.,2016-06-21 15:55:00,link,37,34,44,115
10513336322,Boomy McBoomface to clean up the sea.,2016-06-22 16:30:00,link,191,57,44,292
25902406772,This pretty much sums up the Atlanta Braves season.,2016-06-18 11:16:46,link,14,56,29,99
18807449704,What's going on with Taylor Swift and Tom Hiddleston?,2016-06-15 17:50:00,link,53,49,49,151
112638779551,Keep up to date with all of the overnight action from the 24 Hours of Le Mans.,2016-06-18 18:58:58,link,89,46,26,161
25902406772,Thurman vs Porter may be the fight that boxing needs.,2016-06-22 12:49:16,link,28,71,16,115
52150999700,The actress has been rushed to the hospital after being removed from an international flight on Monday.,2016-06-20 20:36:10,link,11,88,1,100
25902406772,Jamal Murray over Buddy Hield??,2016-06-22 16:19:08,link,53,13,28,94
86680728811,"Prince William becomes first royal family member photographed for cover of gay publication. ""No one should be bullied for their sexuality. Don't put up with it. Be proud of the person you are.""",2016-06-15 23:12:58,link,36,7,7,50
7245371700,"FYI, A Nickelodeon GUTS reunion happened 😱",2016-06-22 04:22:38,link,179,89,28,296
25902406772,"""I think this team accomplished a lot of great things individually and as a team, and those things can never be taken away."" - Draymond Green",2016-06-20 09:32:23,link,157,88,44,289
52150999700,Police are on the lookout for Sinéad O'Connor after receiving a scary call from her family.,2016-06-23 21:01:02,link,183,45,12,240
112638779551,The Jacksonville Jaguars rookie says he'll be ready to go after missing the OTAs and minicamp with a knee injury.,2016-06-16 09:40:21,link,195,28,43,266
75932763901,OMG! Some of these photos are definitely going to embarrass the famous fam...,2016-06-22 20:30:00,link,186,88,44,318
5281959998,Will those free ticket vouchers from the Ticketmaster lawsuit really get you anything?,2016-06-21 11:55:00,link,128,56,26,210
86680728811,Celebrities and animal activists in the U.S. and China are rallying to stop a Chinese dog meat festival that will lead to the slaughter of thousands of dogs.,2016-06-22 14:25:04,link,86,63,25,174
18807449704,"Alligator attacks are, in fact, extremely rare.",2016-06-15 16:45:00,link,24,73,21,118
13652355666,"""Hillary Clinton may be the most corrupt person ever to seek the presidency,"" Donald J. Trump said.",2016-06-22 10:21:25,link,19,2,35,56
112638779551,"""The better team won.""- Golden State Warriors head coach Steve Kerr on the Cleveland Cavaliers",2016-06-19 23:22:20,video,83,56,24,163
5281959998,The hero of the breakfast table. (via The New York Times Food),2016-06-19 07:25:00,link,187,45,20,252
13652355666,"To #Brexit, or to #Bremain? Polls have closed in the United Kingdom's historic vote on remaining in European Union.",2016-06-23 16:17:32,link,185,82,5,272
52150999700,The Star Trek movie series is leaving Netflix next month and heading to Hulu! 💫,2016-06-22 19:01:00,link,84,45,48,177
13652355666,Summer's here.,2016-06-20 05:42:05,photo,157,57,14,228
112638779551,The IAAF has extended a ban that was put in place last November as a punishment for a state-sponsored doping program.,2016-06-17 10:56:52,link,139,10,29,178
10606591490,"Laverne Cox: ""Hairography is what you do.""",2016-06-21 17:30:18,link,175,36,48,259
112638779551,Serena Williams and Novak Djokovic are the top seeds at Wimbledon.,2016-06-22 09:20:22,link,147,31,34,212
95926963131,Two parents say they fear their kids could have suffered the same fate as the Nebraska toddler.,2016-06-16 07:44:06,link,124,24,20,168
18807449704,It's actually really simple.,2016-06-22 16:00:00,link,129,42,3,174
25902406772,Cam Robinson and Hootie Jones will have to deal with the consequences.,2016-06-22 12:07:12,link,112,63,6,181
13652355666,"Wholesome, organic food — served fast.",2016-06-17 07:03:00,link,77,5,19,101
5281959998,"Coach Steve Kerr's anxiety was so pronounced that over the final weeks of the Golden State Warriors' season ""slippage"" became one of his favorite words.",2016-06-20 20:40:00,link,30,7,27,64
52150999700,Whoa! One Orange Is the New Black actress discusses her shocking season 4 scene: http://share.ew.com/g5OJnp4 😱,2016-06-20 20:22:00,video,147,16,37,200
95926963131,Chelsea Clinton has given birth to baby number two! (via People Babies),2016-06-18 11:27:02,link,26,94,15,135
18807449704,🔥 🔥 🔥,2016-06-18 21:00:01,link,21,57,18,96
52150999700,George Lopez breaks down the flaws in Donald J. Trump's plan on The Late Show with Stephen Colbert.,2016-06-15 07:46:00,link,42,8,7,57
7245371700,"I wouldn't mind being trapped in that box either, Rihanna.",2016-06-17 09:26:39,link,61,39,3,103
112638779551,A high school baseball coach reportedly admitted that he had been selling crystal meth to make some extra cash.,2016-06-16 16:27:39,link,47,80,3,130
25902406772,Beer Pong with the Cleveland Cavaliers is legendary.,2016-06-22 09:42:47,link,122,29,40,191
18807449704,SKILLS!,2016-06-17 00:00:00,link,184,85,31,300
95926963131,"Watch out, Saturday Night Live!",2016-06-19 09:20:18,link,149,95,17,261
10606591490,Here's what science says is most important.,2016-06-15 07:30:05,link,123,47,8,178
52150999700,The American Gods television adaptation of Neil Gaiman's novel looks AWESOME!,2016-06-19 10:15:00,link,120,45,3,168
25902406772,The Cleveland Cavaliers will NOT quit.,2016-06-16 22:46:18,photo,58,64,28,150
13652355666,"Currently, many marijuana businesses have trouble finding financial services.",2016-06-22 04:00:00,link,191,1,3,195
112638779551,"""If I play Game 5, we win. But I didn't.""",2016-06-15 14:02:56,link,98,16,24,138
10606591490,Everyone's favorite Oscar winner is now a businessman.,2016-06-16 22:30:05,link,61,14,33,108
95926963131,Talk about precious cargo! The new Storks Movie trailer has arrived.,2016-06-16 09:43:35,video,43,70,3,116
7245371700,"You're welcome, Spotify users.",2016-06-23 23:54:22,link,12,28,22,62
52150999700,Neil Patrick Harris' family is too cute for words. 😍,2016-06-15 21:45:00,link,31,92,45,168
25902406772,A fairytale ending for LeBron James and the Cleveland Cavaliers.,2016-06-19 21:42:07,video,144,6,27,177
18807449704,A+ effort.,2016-06-21 03:00:01,link,152,78,41,271
112638779551,"It all comes down to one game, and these four factors will go a long way to deciding to the 2016 NBA Champion.",2016-06-19 07:00:00,link,138,47,29,214
86680728811,"JUST IN: Pres. Barack Obama to award Lt. Colonel (Ret.) Charles Kettles, U.S. Army, the Medal of Honor for conspicuous gallantry.",2016-06-21 16:23:27,photo,193,85,28,306
5281959998,"The gun industry lobbyists may be beyond reason, but the lawmakers have a duty to respond to their constituents. Read on in The New York Times Opinion Section.",2016-06-16 07:55:00,link,80,66,16,162
86680728811,"A super PAC titled ""Americans Against Insecure Billionaires with Tiny Hands"" released a minute-long ad questioning whether or not real estate mogul-turned-presumptive Republican presidential nominee Donald J. Trump would be able to serve as president with his ""little hands."" http://abcn.ws/1UUh0ne",2016-06-18 12:04:20,link,96,27,6,129
52150999700,Whoa–Bates Motel on A&E season 5 looks JUST like Alfred Hitchcock's Psycho.,2016-06-16 19:20:00,link,186,26,10,222
75932763901,We all know Zac Efron is seriously HOT – but just wait till you see how hot his little brother Dylan is today! –> http://bit.ly/1UbfwCF,2016-06-16 19:00:01,photo,32,30,5,67
95926963131,INSTANT is at VidCon—the Internet's most famous convention!,2016-06-23 15:22:55,video,112,38,11,161
95926963131,Lane Graves was playing in about 6 inches to one foot of water in the Seven Seas Lagoon at Disney's the Grand Floridian Resort & Spa when an alligator grabbed the boy and pulled him under the water.,2016-06-16 22:28:14,video,68,65,50,183
112638779551,Joanne Calderwood says that she's no longer fighting to please anybody but herself from now on.,2016-06-16 17:38:41,link,9,77,23,109
25902406772,Stephen Curry knows what he has to do on Sunday to possibly repeat.,2016-06-18 16:50:22,link,31,43,38,112
10606591490,"""We never thought that would be the turning point.""",2016-06-16 14:30:21,link,169,24,21,214
95926963131,El Chavo del Ocho star Rubén Aguirre has died at age 82.,2016-06-17 19:28:06,link,27,34,43,104
18807449704,This is the stuff of nightmares. 😱,2016-06-16 00:10:00,link,157,6,33,196
52150999700,Fun Home on Broadway is taking its show on the road. 🚘  🎤,2016-06-21 22:31:00,link,55,35,46,136
5281959998,"""This case tells everyone, white and black, guilty and innocent, that an officer can verify your legal status at any time,"" Justice Sonia Sotomayor wrote in a fiery dissent. ""It says that your body is subject to invasion while courts excuse the violation of your rights. It implies that you are not a citizen of a democracy but the subject of a carceral state, just waiting to be cataloged.""",2016-06-20 18:59:13,link,28,80,40,148
25902406772,Marquess Chriss has been traded to the Phoenix Suns.,2016-06-23 20:26:59,link,113,3,2,118
7245371700,"This looks like it's going to be epic, i am donald.",2016-06-20 16:05:33,link,36,22,48,106
5281959998,Get ready for bidding wars in New York's wish-list suburbs.,2016-06-17 19:25:00,link,70,2,43,115
10606591490,"""Once I reached my 40th birthday, I decided I didn't really care about cool or uncool anymore, so I bought a board.""",2016-06-23 00:00:25,link,82,21,26,129
112638779551,"The trial to determine LeBron's legacy gives its opening argument tonight in  Game 6, says Rob Perez:",2016-06-16 14:42:32,link,179,79,39,297
25902406772,Find out when and how to watch the 2016 Quicken Loans National on television and streaming online.,2016-06-22 14:45:12,link,50,52,49,151
10606591490,They will begin phase one with 40 healthy adults.,2016-06-21 03:30:09,link,18,29,11,58
95926963131,The deadly organism can be found lurking in warm waters across the country.,2016-06-23 17:56:06,link,163,68,33,264
10513336322,"Simple, clear updates as counting continues in Britain's vote on whether to leave or remain in the European Union",2016-06-23 19:20:56,link,11,51,46,108
10606591490,From Toy Story to Finding Dory.,2016-06-21 02:00:28,link,31,44,28,103
25902406772,It's a HUGE game for U.S. Soccer.,2016-06-16 20:28:05,link,125,21,47,193
86680728811,NEW: Four measures addressing gun violence fail in Senate.,2016-06-20 18:03:57,link,25,20,12,57
5281959998,Update: Divers found the body of a 2-year-old boy who was dragged away by an alligator at a Disney resort. Read more: http://nyti.ms/1UVB4mo,2016-06-15 17:26:11,photo,100,42,16,158
7245371700,How has the Orlando massacre changed the conversation about LGBTQ pride in America?,2016-06-15 16:06:16,video,143,3,16,162
52150999700,The wacky new Suicide Squad poster is a big bowl of AWESOME. 🙌🏻,2016-06-20 14:38:00,link,163,100,5,268
10606591490,"""I beat the hell out of them""",2016-06-18 15:30:21,link,198,24,31,253
112638779551,"The cutest fan at the Cleveland Cavaliers championship parade? Yup, this baby stole the show!

Andy Nesbitt for @TheBuzzer",2016-06-22 13:56:33,video,98,43,5,146
5281959998,$80 for an hour of cuddling.,2016-06-19 20:25:00,link,153,59,7,219
75932763901,Congrats!! 👶,2016-06-15 13:31:00,link,36,23,11,70
18807449704,The Internet loves this grandma.,2016-06-19 06:00:00,link,164,73,42,279
86680728811,"Connecticut Senator Chris Murphy, frustrated by inaction on gun control, leads marathon talk-a-thon on the Senate floor. ""Voters have to elevate this issue on their priority list."" http://abcn.ws/1ZSJaAD",2016-06-15 22:50:28,video,46,38,29,113
52150999700,Ryan Kwanten and Maggie Grace are just two more of the actors who are joining the action-packed thriller.,2016-06-23 00:15:00,link,151,85,11,247
10513336322,Heard the one about the EU banning bagpipes? Bendy cucumbers? Children blowing up balloons? Or the one about it renaming yoghurt 'fermented milk pudding'?,2016-06-23 03:20:00,link,19,76,50,145
52150999700,Judith Hill was on the plane that made an emergency landing days before Prince's death.,2016-06-21 21:46:22,link,6,32,47,85
112638779551,One more sleep. #USOpen,2016-06-15 21:01:31,photo,64,86,21,171
25902406772,Cleveland Cavaliers wanted Draymond Green suspended for another game.,2016-06-16 11:39:16,link,103,15,27,145
112638779551,Cleveland Browns icon Jim Brown believes LeBron James has earned a statue after leading the Cleveland Cavaliers to the title.,2016-06-20 19:14:07,link,128,82,12,222
7245371700,"When viewed in full detail, the graphic crime scene photos from the O. J. Simpson case carry a narrative of their own.",2016-06-17 18:51:09,link,89,95,46,230
25902406772,Mo Wilkerson is still not happy with the lack of progress on a new contract.,2016-06-16 08:17:52,link,91,72,30,193
5281959998,"""Children of tomorrow will have no understanding of the English language,"" an Apple's senior vice president said jokingly.",2016-06-20 23:25:00,link,57,77,47,181
52150999700,It's official—Helen Mirren is riding into the Fast & Furious franchise! 🙌🏻,2016-06-15 12:26:09,link,128,31,37,196
52150999700,Seth Meyers is going ALL out to make sure Donald J. Trump doesn't feel welcome. 😱,2016-06-15 11:52:00,link,164,22,27,213
52150999700,The ladies from UnREAL are on this years Emmys / Television Academy ballot! 🎥,2016-06-18 09:30:00,link,143,60,31,234
86680728811,Power lines appear to spark as massive Southern California wildfire continues to spread and residents ordered to evacuate from hundreds of homes. http://abcn.ws/28MQH0e,2016-06-20 20:37:34,video,69,25,29,123
75932763901,RIP — Our hearts are hurting for James Van Der Beek during this difficult time —> http://bit.ly/1XxXUGO,2016-06-19 12:00:11,photo,162,73,50,285
112638779551,"Who needs a gym membership when you've got a car?

Andy Nesbitt for @TheBuzzer",2016-06-22 14:20:39,video,174,32,42,248
10513336322,"If you want to learn about Britain's future in Europe as it is announced, when should you nap and when should you tune in?",2016-06-23 14:00:01,link,7,90,48,145
95926963131,LA Lakers star Nick Young is already feeling the blues.,2016-06-23 22:20:08,link,75,94,6,175
7245371700,Making me wish dragons were real.,2016-06-19 18:51:04,link,110,30,20,160
112638779551,The slumping Hanley Ramirez looked straight into the camera and mocked his doubters with an indescribable charade.,2016-06-23 07:37:19,link,16,53,46,115
5281959998,Tips for parenting the child about to leave the nest.,2016-06-15 21:55:00,link,92,49,44,185
18807449704,Brace yourselves -- the Game of Thrones finale is almost here and it looks epic.,2016-06-20 09:38:14,link,122,26,14,162
25902406772,"The Los Angeles Angels have a star in Mike Trout, but they have other issues.",2016-06-17 10:12:12,link,144,30,20,194
5281959998,"The Orlando gunman drove around before the shooting visiting locations, apparently looking at potential targets for a massacre, Orlando's mayor said.",2016-06-15 12:55:00,link,191,6,38,235
52150999700,The new Star Trek series will be unlike ANYTHING you've seen from that universe.,2016-06-23 17:16:00,link,167,80,40,287
95926963131,Brad Paisley can't resist a good love story. (via People Country),2016-06-19 17:40:07,link,184,96,37,317
10606591490,3. Learn a foreign language.,2016-06-18 23:00:38,link,51,99,1,151
10606591490,Graves was playing in shallow water at Disney World when he was grabbed by an alligator,2016-06-16 17:40:21,link,65,25,25,115
112638779551,"Miguel Cabrera desperately tried to give Jose Abreu a hug, but he wanted no part of it.",2016-06-15 07:55:06,link,102,49,17,168
10606591490,Adorable.,2016-06-15 01:00:20,link,147,49,13,209
52150999700,"The Game of Thrones season 6 finale will be just as epic as the Battle of the Bastards, but for VERY different reasons. 😱",2016-06-22 13:11:11,link,87,81,1,169
25902406772,The Boston Celtics are keeping their finger to the pulse.,2016-06-16 18:41:37,link,66,44,37,147
86680728811,Dads across the globe are taking part in the #CheerioChallenge craze that's daring fathers everywhere to stack the cereal as high as it will go on their babies' heads.,2016-06-20 15:09:49,link,100,58,25,183
86680728811,"Iraq's government forces dislodged ISIS from two neighborhoods in Fallujah as an Iraqi military commander claimed the month-long offensive to recapture the city had left 2,500 ISIS militants dead.",2016-06-21 15:47:27,link,80,80,44,204
10513336322,"""Why are the really good skaters falling over the most? The reason is actually quite simple.""",2016-06-20 09:20:00,link,64,16,37,117
18807449704,REALLY?!,2016-06-21 23:54:22,link,115,47,49,211
13652355666,Warm up the oven!,2016-06-22 12:46:00,link,178,90,48,316
10513336322,"Eddie Izzard: ""We gradually move forwards, not backwards. That above all is my argument for remaining in Europe: is this not the story of humanity?""",2016-06-15 07:20:01,link,56,9,44,109
86680728811,"In 120 degree temperatures, some airplanes might not take off, and power grids strain as the outside air keeps transmission lines from cooling. http://abcn.ws/1ScIyQ5",2016-06-19 20:20:06,link,71,87,21,179
10513336322,"'In 1944, a British soldier fighting in Italy was knocked unconscious by shell fragments. That same day in Monmouthshire, he later recalled, ""my wife was washing up after lunch. My daughter, aged two and a half, to whom I was only a name, was playing with some bricks on the kitchen floor. She suddenly got to her feet, went over to my wife, said 'Daddy's been hurt,' and went back to her bricks.""'",2016-06-18 02:20:00,link,171,99,2,272
5281959998,"For years, diplomats were more comfortable talking about nuclear warheads than sexual orientation. The attack in Orlando has changed that.",2016-06-15 02:25:18,link,58,79,48,185
75932763901,RIP — our thoughts are with Caitlyn Jenner during this difficult time: http://bit.ly/28Oaugx,2016-06-23 10:30:00,photo,3,97,39,139
10513336322,"""The Battlefield experience that many fell in love with – that idea of an intuitive military sandbox where air, vehicle and infantry combat seamlessly combine – is here again.""",2016-06-20 09:51:00,link,178,49,11,238
25902406772,The Denver Nuggets just got a guy who gets BUCKETS.,2016-06-23 19:22:22,photo,54,9,36,99
52150999700,The Ghostbusters vs. the Avengers would be one EPIC battle. 😂,2016-06-16 13:37:06,link,162,27,30,219
95926963131,Kylie Jenner flaunted the one-piece she stole from Kris Jenner on Snapchat. (via PeopleStyle),2016-06-20 10:18:05,link,75,63,50,188
7245371700,"When police can use evidence obtained illegally, what does that mean about our legal system?",2016-06-23 16:30:00,video,13,63,50,126
18807449704,"Whether you swim or you bark, love is love.",2016-06-24 02:00:00,link,37,22,37,96
52150999700,Neil Patrick Harris' family is just the cutest. ❤️,2016-06-19 14:09:01,link,29,15,44,88
75932763901,"Congratulations, Anne Hathaway! Get the exciting news (via Closer Weekly) —> http://bit.ly/1Uf3hKE",2016-06-18 06:00:00,photo,74,87,27,188
10606591490,Try adding these habits to your daily routine.,2016-06-17 00:00:11,link,172,2,20,194
13652355666,"The ""day of reckoning"" is here.",2016-06-23 07:14:26,link,152,24,37,213
10513336322,"""Looking attractive is all well and good, but dare to engage in actual sexual activity and suddenly you're a slut.""",2016-06-22 14:30:01,link,141,70,27,238
86680728811,"The Chan Zuckerberg Initiative has made its first major donation to a company that finds and trains developers in Africa: ""Developers in Africa get the opportunity to use their skills and support their communities."" http://abcn.ws/1UdF4PK",2016-06-17 13:09:03,link,102,94,35,231
25902406772,The pressure is on Portugal and Sweden.,2016-06-22 12:56:16,link,156,45,7,208
10513336322,"""Not one of Donald Trump's reckless ideas would have saved a single life in Orlando. A ban on Muslims would not have stopped this attack. Neither would a wall. I don't know how one builds a wall to keep the internet out.""",2016-06-16 01:40:00,link,140,92,10,242
52150999700,Pearl Jam fans were in for a HUGE treat. 🎸  🔥,2016-06-19 20:01:00,link,7,43,29,79
25902406772,The Carolina Panthers GM admitted that money is a big factor.,2016-06-23 13:19:38,link,103,95,26,224
5281959998,VW's ex-CEO is being investigated in Germany. He's the first top manager named as a suspect in an emissions scandal.,2016-06-20 09:25:00,link,105,85,7,197
86680728811,"Attorney General Lynch is visiting Orlando today, 10 days after the worst mass shooting in recent U.S. history took place at Pulse, a gay nightclub.",2016-06-21 10:56:46,link,53,59,47,159
10513336322,"""Where our different personas are problematic, you can make a conscious choice to be someone else, someone better. This applies even to the most distressed of us.""",2016-06-21 13:40:00,link,102,55,39,196
10513336322,"""These Antarctic islands were once covered by ocean, when non-avian dinosaurs roamed the land, giant marine reptiles swam the seas, and swarms of strange fish schooled along the shores. We know these islands were warmer back then, teeming with plant and animal life, yet we know so little about the species that lived there.""",2016-06-15 11:20:01,link,174,17,7,198
52150999700,"Big news, Shrek fans! A franchise revival could be in the works: http://share.ew.com/z6QCAoo 👌🏼",2016-06-15 15:51:00,video,163,3,39,205
10513336322,"What do Donald Trump, ""moist"", and Pantone 448 C have in common?",2016-06-21 11:40:00,link,125,52,42,219
112638779551,"LeBron James is the greatest in the game today. Thanks to him, the Cleveland Cavaliers are NBA champions.",2016-06-19 23:27:17,link,87,92,35,214
10606591490,Donald Trump fires campaign manager Corey Lewandowski. http://ti.me/28Jfy3E,2016-06-20 14:15:40,video,182,86,38,306
25902406772,Cristiano Ronaldo wasn't too happy.,2016-06-22 12:55:15,link,9,33,36,78
10513336322,Follow all the action live as England meet Wales in Euro 2016.,2016-06-16 06:40:01,link,95,36,23,154
112638779551,"As #FathersDay approaches, a handy guide on how to become a great sports dad.",2016-06-17 15:58:53,link,17,2,8,27
13652355666,"Police shot and killed a masked gunman in Germany, at least 25 people are injured.",2016-06-23 16:30:00,video,170,54,9,233
10606591490,"""It's really a physical thing, you need to be there, walking it, on the streets, here""",2016-06-18 12:30:03,link,62,10,16,88
7245371700,Kibbles n' Boltons is all the rage in Westeros.,2016-06-21 16:44:42,link,62,93,36,191
5281959998,"One of New York City's most famous immigrants arrived from France in 212 crates on this day in 1885.

131 years later, 🗽  is still standing. http://nyti.ms/1UDJMG2

Photo: Jewel Samad/Agence France-Presse — Getty Images",2016-06-17 13:55:00,photo,54,1,22,77
52150999700,The cast for STARZ's American Gods is really shaping up nicely! 💯,2016-06-15 13:51:00,link,39,64,10,113
25902406772,Jake Long is ready to get back on the field.,2016-06-18 16:34:56,link,51,11,17,79
86680728811,"Sheriff updates on 2-year-old boy taken by alligator at Walt Disney World resort: ""We are dealing with this family now, who there's no question will lose a 2-year-old child."" Disney World has temporarily closed all resort beaches and recreational marinas in the wake of the gator attack. http://abcn.ws/1Yr4EFD",2016-06-15 11:23:19,video,39,33,43,115
52150999700,Dame Judi Dench is no stranger to playing royalty! 👑,2016-06-17 17:55:00,link,152,49,8,209
7245371700,What happens when Central Intelligence duo Dwayne The Rock Johnson + Kevin Hart have an *adorable* showdown?,2016-06-16 10:57:19,video,17,23,48,88
7245371700,Chad has somehow managed to get back at one of his former competitors AFTER leaving The Bachelorette.,2016-06-21 17:34:18,link,87,88,9,184
25902406772,"Some New York Jets just don't wanna talk about it, alright??!?!?! sheesh.",2016-06-23 18:01:42,link,18,6,18,42
7245371700,Is Arya headed to Winterfell or what??,2016-06-16 03:31:45,link,44,82,6,132
112638779551,"Cleveland, Ohio sports team fans were so close to a title in 1997. The Cleveland Indians stretched the World Series to seven games and beyond. But it wasn't to be.",2016-06-17 12:41:29,link,190,82,41,313
7245371700,Is Arya headed to Winterfell or what??,2016-06-21 03:13:05,link,45,46,41,132
112638779551,Packers linebacker Jayrone Elliott was one of several VIPs who took a turn riding with the racing legend at IndyCar's return to Road America.,2016-06-23 14:31:34,link,158,46,22,226
18807449704,Poor Daniel Radcliffe 😞,2016-06-16 04:36:01,link,128,45,16,189
10606591490,Making a great cup of coffee is less about what you put into it once it's brewed.,2016-06-16 00:30:14,link,161,38,45,244
25902406772,"Don't mess with Iceland, Cristiano Ronaldo.",2016-06-15 13:38:03,link,111,84,3,198
75932763901,CONGRATULATIONS! Kylie Jenner shares TWO names after her Instagram baby announcement —> http://bit.ly/28PRTju,2016-06-21 12:31:06,photo,4,3,31,38
13652355666,"A candidate for congress is taking heat for his controversial billboard in Benton, Tennessee.",2016-06-22 23:05:00,video,183,25,20,228
13652355666,"In December 1995, Mateen was referred to a student study team for continuing to hit students, talking out in class and screaming at teachers and fellow students, according to records.",2016-06-16 01:49:00,link,31,18,1,50
112638779551,"The NFL and NBA have grown in popularity, but New York Yankees slugger Alex Rodriguez believes baseball will reclaim its title as the No. 1 sport soon.",2016-06-21 18:15:19,link,56,84,17,157
7245371700,"Here's what you 'Need to Know' on 6/16 from Taylor Swift, Tom Hiddleston, Ashton Kutcher, Mila Kunis, and Nicki Minaj.",2016-06-16 05:23:30,video,158,87,27,272
75932763901,What was she thinking?!,2016-06-23 00:00:00,link,118,14,27,159
13652355666,The cause of the fire was not known.,2016-06-15 23:44:00,link,58,14,30,102
10606591490,Beyoncé is making waves in Hawaii.,2016-06-22 19:01:02,link,149,87,19,255
52150999700,We'll miss the Orphan Black sestras!,2016-06-16 10:45:24,link,90,51,43,184
112638779551,Everything you need to know for Thursday's opening round,2016-06-16 07:44:28,link,117,49,20,186
86680728811,"California's drought and a bark beetle epidemic have caused the largest die-off of Sierra Nevada forests in modern history, raising fears that trees could come crashing down on people or fuel deadly wildfires that could wipe out mountain communities. http://abcn.ws/1UqFBjE",2016-06-19 18:25:32,link,63,75,5,143
25902406772,You don't see this everyday.,2016-06-19 13:56:30,link,40,5,3,48
7245371700,Nothing can stop Lil Wayne.,2016-06-16 15:35:30,link,115,58,18,191
52150999700,YouTube sensation-turned-pop star Charlie Puth cries to Celine Dion just like us.,2016-06-18 03:27:00,link,110,35,34,179
112638779551,A look back at the time 19-year-old LeBron James went to WWE Raw as a rookie,2016-06-23 12:14:35,link,39,88,33,160
25902406772,A-Rod is creeping toward 700.,2016-06-19 16:49:08,link,7,54,10,71
10513336322,"Timothy Spall: ""I don't like doing anything unless I can do it well. That's why I don't do very much. Apart from act.""",2016-06-22 12:00:01,link,39,91,43,173
112638779551,"This guy won a half marathon... in dress shoes. DRESS SHOES!!

Kristen Balboni for @TheBuzzer",2016-06-20 11:47:18,video,67,33,50,150
86680728811,9/11 firefighter laid to rest nearly 15 years after terror attack on World Trade Center. http://abcn.ws/1YxAqAV,2016-06-17 11:30:00,photo,129,67,33,229
10606591490,"""Why would you put a child underneath so much water at once?""",2016-06-17 17:30:07,link,11,10,25,46
18807449704,Maybe we didn't want it that badly,2016-06-20 05:00:00,link,26,82,5,113
25902406772,14 players have been reportedly invited to attend the draft in the green room.,2016-06-18 17:50:00,link,148,12,43,203
7245371700,"Aww, it's hard to spread your wings in this big, big world.",2016-06-15 21:48:50,link,159,1,25,185
25902406772,"Hey Vegas, you should get your welcome party for the NHL ready for the 2017-2018 season.",2016-06-22 15:52:28,link,27,9,5,41
75932763901,BABY BUMP ALERT! This supermodel mommy-to-be can't hide her growing belly! http://bit.ly/25IVBWy,2016-06-21 10:32:41,photo,166,66,45,277
7245371700,"""We need to stand up and be heard"" (via MTV UK)",2016-06-15 11:19:42,video,64,57,26,147
10513336322,"""For every woman that burned her bra, there is a man burning to wear one,""",2016-06-17 13:00:00,link,51,19,13,83
52150999700,"Arrow fans, the Chicago P.D. star is coming to Star City. 😱🔥",2016-06-16 15:42:00,link,54,46,48,148
10513336322,Avocado pare.,2016-06-15 06:40:01,link,87,16,19,122
75932763901,THAT SMILE! This famous mommy got her babies all dolled up — wait until you see her beautiful daughter! --> http://bit.ly/1V2ppSO,2016-06-24 15:00:00,photo,117,52,10,179
7245371700,"""Rockin' that white and gold.""",2016-06-21 15:52:55,link,84,76,29,189
13652355666,"Breathe in, breathe out.",2016-06-21 10:17:00,photo,189,91,13,293
10513336322,"""It is not difficult to imagine the reaction if England's most important player – say, Wayne Rooney – had ushered in this match by boldly announcing that none of the Wales players, Gareth Bale included, was good enough to get into Roy Hodgson's team.""",2016-06-16 03:50:00,link,14,82,23,119
5281959998,The Central Park bench. You aren't just sitting on wood. You're sitting on memories.,2016-06-19 14:25:00,link,90,19,5,114
112638779551,Former Cleveland Browns and Miami Dolphins WR Davone Bess reportedly was arrested Monday after a standoff with police and a SWAT team in Arizona.,2016-06-21 09:07:13,link,18,93,19,130
86680728811,Happy 34th birthday to Prince William! Take a look back on Prince William's early childhood. abcn.ws/28LCgOv,2016-06-21 15:35:37,video,184,15,11,210
75932763901,"North West is only 3 years old — which is why it's SHOCKING that her parents spend $5,000 A WEEK on THIS! (via Life & Style Weekly) —> http://bit.ly/1YuDe1S",2016-06-17 02:15:00,photo,22,17,35,74
10606591490,Their reactions are priceless.,2016-06-18 04:00:20,link,96,70,36,202
10606591490,Itching for a career change?,2016-06-19 11:00:42,link,116,83,18,217
10513336322,"Immigration is the deciding factor for many referendum voters, even in areas where the vast majority of people are white British...",2016-06-20 03:00:00,video,190,60,40,290
75932763901,OMG! Can you believe he wins?!,2016-06-20 21:00:01,link,96,79,20,195
18807449704,Animal biting has never been so adorable.,2016-06-23 00:30:00,link,6,68,36,110
18807449704,😍 😍 😍,2016-06-19 18:00:00,link,54,21,47,122
5281959998,"Additional security procedures are likely to become more common in the U.S., making the experience of going to a concert more like waiting in line at the airport.",2016-06-15 03:55:00,link,4,90,37,131
25902406772,An impressive play by the Pittsburgh Pirates ballgirl.,2016-06-21 12:31:27,link,126,88,35,249
75932763901,"""Maybe in a couple years, we'll get back together and have some more babies."" See which star is hoping for a reconciliation with her ex —> http://bit.ly/1Sbobms",2016-06-18 16:00:00,photo,188,53,32,273
86680728811,"Surveillance video shows woman stealing a car - with two kids inside - from a California gas station while dad went inside, police say. ""He was in shock, like crying and yelling, 'Call 911!'"" http://abcn.ws/28RGqjm",2016-06-22 00:59:25,video,115,6,44,165
75932763901,"Kelly Ripa's husband, Mark Consuelos, just made a HUGE announcement — and 'Live! With Kelly' fans will be thrilled (via Closer Weekly) —> http://bit.ly/1R8OJ7r",2016-06-21 05:30:00,photo,125,96,37,258
95926963131,The Bravo star and her husband have been married for eight years.,2016-06-16 09:35:32,link,125,3,29,157
112638779551,"WWE's 'Money in the Bank' pay-per-view is this weekend, so we're reliving some of the most ridiculous moments in recent wrestling history. Now, can someone find us a ladder?",2016-06-17 14:56:25,link,45,39,2,86
25902406772,Never change Phil Mickelson.,2016-06-16 11:05:33,link,166,12,31,209
7245371700,Real World: Seattle set the bar high.,2016-06-19 22:31:05,link,200,47,1,248
112638779551,The New Orleans Saints quarterback expects to get an extension soon but isn't afraid to play into the final year of his contract if he has to.,2016-06-22 13:28:22,link,106,27,19,152
25902406772,What was expected to be a 50-50 split of the costs is looking more like an 80-20 split.,2016-06-22 13:37:21,link,189,27,28,244
25902406772,Stephen Curry is now... LeBron?,2016-06-22 08:38:20,link,194,41,5,240
7245371700,JAY Z with the assist.,2016-06-20 18:43:13,link,178,69,23,270
112638779551,"Cleveland Cavaliers star LeBron James has been on a ""social media hiatus"" since the start of the NBA playoffs.

But Monday he returned in a big way... by absolutely CRUSHING anyone who has doubted him through the years...",2016-06-20 17:45:34,link,100,72,30,202
7245371700,Bootleg Kanye West merch for all!,2016-06-22 12:23:58,link,130,89,26,245
95926963131,Three cheers for these incredible rescuers! (via PEOPLE Pets),2016-06-15 01:01:02,link,16,37,13,66
75932763901,Paris Hilton just threw major shade at her former BFF Kim Kardashian West — and we can't wait to see how Kim reacts after seeing THIS —> http://bit.ly/28PrDY5,2016-06-23 11:02:21,photo,37,54,45,136
7245371700,Blake Lively has expensive taste.,2016-06-18 17:49:02,link,22,90,22,134
86680728811,"The sheriff's office said the boy's mother heard screaming while he was playing outside in the front yard. The mother ran outside, where she saw the animal on top of her son, and dragged the boy away. http://abcn.ws/1Y1gsQI",2016-06-18 13:30:36,link,112,81,50,243
86680728811,Senators introduce bipartisan bill on gun safety that its supporters hope can unite enough lawmakers on both sides of the aisle.,2016-06-21 21:41:49,link,23,72,17,112
112638779551,Adrian Peterson admits the offseason grind may impact when he decides to retire from the NFL.,2016-06-22 09:29:48,link,165,32,47,244
75932763901,"IT'S A MIRACLE! More than seven months after this cutie was diagnosed with leukemia, his famous father shared amazing news: He's in remission! —> http://bit.ly/1ttJLOn",2016-06-17 08:30:00,photo,162,26,21,209
18807449704,🚨 🚨 THIS IS NOT A TEST. 🚨 🚨,2016-06-21 21:59:00,link,156,91,16,263
5281959998,"The latest U.S. and swing state polls, updated every day through Election Day.",2016-06-18 04:55:00,link,43,5,13,61
25902406772,A lot of golfers are pulling out of Rio.,2016-06-23 09:41:03,link,161,90,26,277
75932763901,RIP: Read Denise Richards' emotional goodbye —> http://bit.ly/28Qc30C,2016-06-23 09:00:00,photo,112,22,25,159
95926963131,MVP LeBron James and the Cleveland Cavaliers won the #NBAFinals in a dramatic game 7 victory. 🏆,2016-06-19 23:07:12,link,183,79,36,298
10513336322,"His hair his greying and the years have taken their toll on his legs, but at 49 Kazuyoshi Miura proved on Sunday he is not ready to retire, after breaking his own record as the oldest goal scorer in Japan's football league.",2016-06-20 05:40:00,link,171,9,17,197
5281959998,"A look at the news right now.

Learn more about these stories at nytimes.com.",2016-06-23 11:08:57,photo,117,82,10,209
52150999700,"Ron Lester, the actor who rose to fame as Billy Bob in Varsity Blues, has died. R.I.P.",2016-06-17 23:04:39,link,125,90,44,259
52150999700,"Following the murder of Christina Grimmie, artist and musicians are teaming up in support of gun safety.",2016-06-23 08:00:00,link,86,17,46,149
112638779551,Philadelphia Eagles long snapper Jon Dorenbos can do more than snap footballs.,2016-06-22 07:40:39,link,31,60,49,140
112638779551,The first major incident of the 24 Hours of Le Mans claims the No. 64 Corvette.,2016-06-19 00:06:56,link,195,3,2,200
10606591490,"""Finding quiet time is about happiness as well as productivity.""",2016-06-21 06:00:44,link,33,55,49,137
10606591490,Humor is attractive to men and women—but not in the same way.,2016-06-18 04:30:10,link,170,76,34,280
10513336322,"""Over the years, the people there became a kind of family where I could be open, becoming myself and eventually being comfortable enough to come out.""",2016-06-16 13:40:05,link,182,34,35,251
75932763901,"Looking good, Kylie Jenner.",2016-06-22 11:30:00,link,125,72,35,232
13652355666,"""I'm sorry if there are people who are just so hateful or fearful of it all.""",2016-06-16 14:15:00,link,193,74,21,288
75932763901,This young teen is causing a LOT of controversy – and it's all because of her racy Instagram posts! We wonder how her famous mom feels...–> http://bit.ly/1sQb9Xn,2016-06-21 08:30:00,photo,61,91,9,161
95926963131,What these two non-profits are doing for seal pups is so touching. (via PEOPLE Pets),2016-06-18 20:00:18,link,195,81,14,290
112638779551,Cardale Jones has an answer for Paige VanZant's call out.,2016-06-17 14:41:40,link,30,86,13,129
18807449704,The decision led to overwhelmingly anger on social media,2016-06-21 05:43:44,link,36,33,38,107
112638779551,Soaking up the love at Wednesday's Cleveland Cavaliers parade.,2016-06-22 11:43:16,link,16,42,48,106
112638779551,Federal investigators say various professional athletes were cheated out of at least $30 million in a Ponzi-like scheme run by their investment adviser.,2016-06-21 15:32:33,link,86,92,9,187
112638779551,"Just a little over 24 hours away! 

Here are the stats you need to know before tomorrow's Golden State Warriors/ Cleveland Cavaliers Game 7.",2016-06-18 14:34:28,video,128,35,14,177
112638779551,"President Obama wasn't about to miss the finish of the NBA Finals, When you are POTUS you can stay on the plane as long as you want.",2016-06-20 00:11:53,link,15,3,1,19
25902406772,Nebraska Cornhuskers football has seen some amazing success.,2016-06-21 10:26:40,link,82,83,26,191
5281959998,"Days before Prince died, ""his eyes fixed,"" and he lost consciousness on a plane. Judith Hill was by his side that night.",2016-06-21 18:34:25,link,164,70,22,256
7245371700,Selena Gomez and Christina Grimmie's friendship went way back.,2016-06-15 04:53:06,link,125,98,30,253
10606591490,These animals receive more pampering than most people.,2016-06-17 23:00:43,link,159,86,40,285
52150999700,Mel Brooks' take on Robin Hood is just legendary. 😂,2016-06-18 22:15:00,link,164,76,19,259
10513336322,Colombia has today reached a historic ceasefire with the Farc after more than 50 years of conflict – why did it take half a century to resolve?,2016-06-23 15:33:00,link,181,99,14,294
7245371700,Bigotry has no place in our schools — but queer students do.,2016-06-22 16:33:19,video,94,9,42,145
18807449704,This is EVERYTHING.,2016-06-21 00:22:58,link,146,100,19,265
10606591490,An outfit says a thousand words.,2016-06-18 00:00:28,link,181,33,43,257
7245371700,Taylor Swift's stationary collection is kinda bomb.,2016-06-18 00:48:21,link,197,14,23,234
112638779551,J.R. Smith's 6-year-old daughter roasted her dad on live TV before Game 6 of the NBA Finals:,2016-06-16 19:49:15,link,16,10,34,60
75932763901,Kate Middleton and Prince William are in A LOT of trouble! Find out why the royal couple are on thin ice (via Closer Weekly) —> http://bit.ly/28KyuDz,2016-06-22 12:00:00,photo,13,66,11,90
95926963131,The most important part of the project are the stories behind the photos.,2016-06-19 11:40:05,link,191,41,20,252
52150999700,Team Arrow just got bigger! 🙌🏻,2016-06-21 12:22:42,link,59,5,19,83
7245371700,A must read for diehard The O.C. fans.,2016-06-18 23:20:52,link,186,33,28,247
10513336322,"""This very morning I heard someone conclude a report by saying that next Thursday's vote will decide the fate not just of Britain but of David Cameron (glad that syntax got the priorities right). We can't say loudly enough that this is not about them: it's about us – about the future of our families, our country, our continent.""",2016-06-18 11:10:00,link,193,67,12,272
18807449704,Stunning.,2016-06-19 00:00:00,link,99,61,27,187
10513336322,"Who's top? It's not Spain, Germany, France, Italy (or England)...",2016-06-23 08:10:01,link,71,79,31,181
25902406772,The Penguins will open their home season against the Washington Capitals.,2016-06-20 12:45:27,link,55,17,37,109
5281959998,"When his brother drowned trying to cross the Mediterranean, Samba Thiam knew that, soon, he would also have to test his luck.",2016-06-16 05:55:00,link,104,17,18,139
25902406772,SMH.,2016-06-23 12:20:37,link,103,22,35,160
25902406772,Metta World Peace is just trying to help out.,2016-06-23 12:16:37,link,23,83,4,110
10606591490,"If you don't break a sweat, is it still a good workout?",2016-06-23 09:00:38,link,70,12,38,120
7245371700,Her super candid live video has me smiling ear to ear.,2016-06-21 14:49:07,link,198,31,1,230
52150999700,Comic book legend Stan Lee is a HUGE fan of Marvel's new Spider-Man!,2016-06-20 10:56:01,link,112,32,46,190
112638779551,Jordan Spieth and Bryson DeChambeau both tried going for the driveable Par 4 17th hole at the U.S. Open Championship. #USOpen #LexusRCF,2016-06-18 12:42:51,video,23,50,50,123
112638779551,Investigative report by Los Angeles Times raises some serious questions regarding USC Trojans AD,2016-06-18 23:16:56,link,146,13,23,182
10606591490,There's even a full-time staff observing the waters.,2016-06-15 22:00:39,link,57,66,7,130
25902406772,Jayson Werth was PUMPED and held nothing back.,2016-06-16 10:50:40,link,106,40,37,183
5281959998,"Have you finished Season 4 of ""Orange Is the New Black""? Samira Wiley talks about Poussey's big episode, written by her girlfriend Lauren Morelli.",2016-06-20 18:40:01,link,96,30,49,175
10513336322,"An audacious operation is under way to rescue a worker from a research center at the South Pole who is in urgent need of medical care, via an airlift which has only been achieved twice in the history of the polar base.",2016-06-22 01:41:00,link,191,59,15,265
112638779551,The meat. The cole slaw. The fries. All stacked between delicious bread. Western PA native Jim Kelly explains why Primanti Bros. IS Pittsburgh. The U.S. Open Championship invades the Steel City this week! #USOpen,2016-06-16 18:59:48,video,135,73,25,233
18807449704,Not everyone believes that Game of Thrones Sansa theory.,2016-06-22 15:30:00,link,55,93,44,192
75932763901,"She looks COMPLETELY different after going under the knife for a nose job, chin implant, and fat injections! 😮 See who debuted her ""new face"" —> http://bit.ly/28WxED4",2016-06-24 15:30:00,photo,142,46,12,200
13652355666,Isle Royale National Park is totally worth the journey. http://usat.ly/28IMwSK,2016-06-21 13:13:00,video,11,26,22,59
86680728811,"Organizers say more than 1,000 people, including GOP delegates, alternates and other supporters, dialed in for a conference call on Sunday night to hammer out details for a last-ditch, sweeping rules change that would unbind delegates at the Republican National Convention and deny Donald Trump the presidential nomination.",2016-06-20 00:56:51,link,96,18,33,147
112638779551,The NBA Draft 2016 is tonight - study up!,2016-06-23 16:37:08,video,172,10,47,229
25902406772,Well... that didn't last long.,2016-06-18 22:51:04,video,161,33,3,197
95926963131,Congratulations to the Sister Wives star—and her new fiancé! ❤️,2016-06-17 18:44:02,link,135,55,29,219
13652355666,"Shanghai Disney Resort covers 963 acres, more than 11 times the size of the original Disneyland in Anaheim, Calif.",2016-06-16 04:49:00,link,99,38,25,162
112638779551,"The Golden State Warriors have a young, secured core and salary cap flexibility. Do they want to shake up the NBA this summer?",2016-06-20 10:41:33,link,19,13,44,76
7245371700,"Cool, it started a conversation about interracial dating but does it still relate to us today?",2016-06-15 01:29:29,link,94,67,14,175
13652355666,Heartbreaking.,2016-06-20 23:20:00,link,158,12,17,187
52150999700,Pretty Little Liars' new season is going to be unlike ANY other season. 😱,2016-06-21 18:25:00,link,67,44,45,156
10513336322,"David Hockney: ""After periods of doing other things, I always come back to the portrait, and have a burst of sanity.""",2016-06-18 03:00:00,link,60,34,41,135
112638779551,Baylor possibly bringing back Art Briles is causing a stir.,2016-06-15 00:06:33,link,6,2,40,48
25902406772,Maybe this is what happens when halftime is 2 hours long...,2016-06-22 23:38:21,link,185,36,16,237
112638779551,Jason Kokrak thought he hit the green at No. 2. Then Oakmont Country Club reminded him it was Sunday at the U.S. Open Championship. #LexusRCF,2016-06-19 12:14:08,video,111,6,41,158
7245371700,"But seriously though, how can you turn down Harvard?",2016-06-22 18:02:48,link,129,38,18,185
25902406772,Not much love for Chip Kelly.,2016-06-18 14:48:29,link,141,25,11,177
75932763901,STRIPPED DOWN! See who posted a totally nude snap on Instagram! –> http://bit.ly/1rgPgyH,2016-06-22 19:30:00,photo,116,28,9,153
86680728811,JUST IN: NTSB sending two investigators to Egypt to help with data recovery from newly-recovered black box. http://abcn.ws/28HI00C,2016-06-16 11:01:17,link,9,4,45,58
10513336322,Many women living in Latin America find it hard to protect themselves against the virus spread by mosquitoes and do not have the option of termination in the event of an unwanted pregnancy.,2016-06-23 12:00:00,link,106,86,24,216
52150999700,Woody Harrelson goes ALL in as a deranged preacher opposite Liam Hemsworth in this bloody Western.,2016-06-22 17:58:00,link,104,60,21,185
13652355666,Mr. Rubio is going back to Washington.,2016-06-22 11:29:00,link,124,39,26,189
10606591490,Ever feel like you're just not getting enough done?,2016-06-17 08:30:35,link,104,61,23,188
112638779551,Stephen Curry likely won't be the only one to get fined after Game 6.,2016-06-17 03:04:26,link,48,24,36,108
112638779551,Cleveland Cavaliers fans are going crazy. Here's the joyous scene in Cleveland.,2016-06-19 23:42:16,link,124,91,23,238
95926963131,"A sneak peek into Saturday night's People's List! Plus hosts Jerry O'Connell and SuChin Pak want to know, what's on your mind?",2016-06-23 18:39:40,video,65,45,15,125
7245371700,"""In 2016, everyone can benefit from behaving in a better, more loving way.""",2016-06-20 06:25:20,link,110,8,47,165
75932763901,"This is what Chelsea Houska looked like back on Halloween – since then, she's shed even more weight! See how tiny she is today –> http://bit.ly/1sEvKgN",2016-06-15 04:45:01,photo,70,33,42,145
13652355666,"British Prime Minister David Cameron called for ""fresh leadership"" after the United Kingdom voted to leave the European Union.",2016-06-24 02:39:44,link,107,15,14,136
10513336322,"""It leaves you thinking about our status as a democracy.""",2016-06-23 19:00:00,link,74,13,17,104
95926963131,The Modern Family star is headed to UCLA in the fall.,2016-06-20 09:56:04,link,162,96,32,290
10513336322,"If you're reading this, we'd just like to take the time to say how very much we appreciate it. It's ever so kind of you. Thank you.",2016-06-16 02:00:01,link,66,16,14,96
75932763901,YIKES! See who showed off some MAJOR side boob on the red carpet!! –> http://bit.ly/28iCt0i,2016-06-21 17:00:00,photo,181,91,45,317
112638779551,"The Indianapolis Colts read ""Mean Tweets,"" and Pat McAfee fired back with some serious heat.",2016-06-15 08:56:51,link,43,33,35,111
10513336322,"""What does Facebook think an ""improved"" society looks like?""",2016-06-18 04:00:00,link,55,45,17,117
5281959998,The 12 golden retrievers arrived after the Orlando massacre with a job to do.,2016-06-16 11:25:00,link,189,19,28,236
5281959998,"He was blindfolded, put on a train and sent hundreds of miles north. Then he was kept in a room alone for 5 months.",2016-06-16 13:55:00,link,164,76,46,286
18807449704,NOPE. NOPE.,2016-06-19 07:00:01,link,113,33,5,151
10513336322,What's the perfect white or rosé to go with grilled fish? Where can you get a bargain red or fizz for the barbecue?,2016-06-19 08:20:00,link,195,37,39,271
52150999700,Roland Emmerich has emphasized that a gay couple is featured prominently in 'Independence Day: Resurgence.',2016-06-20 23:10:00,link,38,34,39,111
7245371700,"Happy Belated Birthday, Lana Del Rey <3",2016-06-23 04:41:56,link,107,44,17,168
10513336322,KAPOW!,2016-06-16 10:00:01,link,69,37,16,122
10606591490,Ramsay Bolton pulled off a shocker.,2016-06-19 22:30:17,link,54,26,11,91
18807449704,Very impressive!,2016-06-21 01:40:01,link,163,13,1,177
10513336322,"""I can't bear it any more, this arrogant, hateful refusal to see. So let me tell you a little bit of queer history, about some of the invisible people: the ones who don't fit into cosy definitions, who aren't white, who bust up gender binaries, who wreak havoc by their very presence.""",2016-06-17 06:40:01,link,76,45,31,152
112638779551,Blunt talk from a Tampa Bay Buccaneers newcomer.,2016-06-20 09:22:05,link,33,77,4,114
52150999700,"Lightsabers, Jedi and Sith, oh my! This new Star Wars series is a hilarious adventure.",2016-06-17 20:32:00,link,163,57,26,246
112638779551,Here's how Clayton Kershaw passed the time during the Dodgers' win Saturday,2016-06-19 10:10:45,link,8,89,8,105
13652355666,USA Today reporter Alan Gomez breaks down the Supreme Court ruling on President Obama's program to protect up to four million undocumented immigrants from deportation.,2016-06-23 13:44:00,video,22,81,32,135
10513336322,"""Whatever zoos do to promote conservation, we know those animals don't want to be in cages. We feel the frustration of the big cats, the terrible sadness of our cousins the gorillas.""",2016-06-19 11:20:00,link,4,53,24,81
18807449704,See also: when your dad is also a ninja.,2016-06-17 11:48:55,link,68,98,3,169
10513336322,"""Can Cameron's intended reconciliation cabinet reshuffle really put Michael Gove and Boris ""Trump"" Johnson around the coffin-shaped table as if nothing has happened? Even that assumes he will scrape home on Friday morning, as most smart money – and the crafty bookies – still expect. Defeated, he will start to look like the most disastrous British prime minister since Lord North lost George III's American colonies in 1783.""",2016-06-22 11:20:00,link,87,33,4,124
5281959998,Do you love sweetness checked by a little heat? Do you love dinner that's ready in just a few minutes? The New York Times Food has the dish for you.,2016-06-20 16:55:01,link,119,77,33,229
7245371700,"Happy Father's Day, Tyga!",2016-06-19 11:15:00,video,124,95,39,258
5281959998,So much for an upset. Argentina crushed the U.S. in the Copa América Centenario 2016 semifinal. Lionel Messi scored on a stunning free kick.,2016-06-21 22:06:24,link,138,20,12,170
18807449704,"A movie was so terrifying, it might have killed a man.",2016-06-19 13:10:00,link,112,43,25,180
7245371700,Real World: Seattle set the bar high.,2016-06-22 06:36:31,link,41,44,1,86
10513336322,"""On the first night, two children were sick and we confiscated more than two kilos of sweets and biscuits from just one bedroom.""",2016-06-19 02:20:01,link,173,14,21,208
10513336322,"""I'm 100% certain that Berta Cáceres was killed by the army.""",2016-06-21 17:23:51,link,31,98,21,150
25902406772,The stars are aligning for an epic Game 7.,2016-06-19 11:06:05,link,78,17,16,111
75932763901,"More than seven months after Criss Angel's son was diagnosed with leukemia, the illusionist shares incredible news with fans —> http://bit.ly/1ttJLOn",2016-06-16 18:00:00,photo,110,50,12,172
52150999700,DC's Legends of Tomorrow is about to get SUPER sized.,2016-06-15 19:48:00,link,34,65,49,148
7245371700,So that's what happened to lonelygirl15.,2016-06-21 20:57:07,link,70,71,38,179
112638779551,"Draymond Green says Bob Myers' support makes him want to be ""A Warrior Forever""

http://www.foxsports.com/nba/story/bob-myers-support-makes-draymond-green-want-to-be-a-warrior-forever-061516",2016-06-15 14:52:40,link,165,27,38,230
13652355666,"BREAKING: A Marine Corps investigation has concluded with near certainty that Pvt. 1st Class Harold Schultz was one of the Marines raising the flag in the photo, but he never said a word.",2016-06-23 06:35:35,link,181,82,16,279
95926963131,Tom Hiddleston just couldn't resist Taylor Swift's impressive dance moves.,2016-06-16 11:03:06,link,156,53,29,238
5281959998,"Long before Falluja was known the world over for deadly jihadists, it was known all over Iraq for its kebab.",2016-06-22 00:55:00,link,175,94,36,305
52150999700,"If you're in the right mood, Blake Lively's The Shallows is an unintentionally hilarious hoot.",2016-06-23 18:53:00,link,180,86,16,282
10513336322,"""You can't work in the justice system and not know just by looking that there are racial disparities in the system.""",2016-06-18 07:40:00,link,137,5,2,144
25902406772,This guy has some unreal power.,2016-06-16 19:37:03,link,52,97,44,193
10606591490,"""I don't think people understand how shy and reclusive and how afraid Andrea is, especially since all this publicity descended on her. She is truly afraid.""",2016-06-20 23:30:14,link,150,34,43,227
10606591490,Time to get rid of the diet soda stash.,2016-06-18 14:00:39,link,167,21,28,216
5281959998,"""I don't love you anymore. I'm not sure I ever did.""",2016-06-18 13:25:00,link,159,86,6,251
86680728811,Happy first official day of summer!,2016-06-20 07:00:00,photo,77,3,15,95
95926963131,Brett Eldredge decided there was no place like home when it came to shoot his new music video.,2016-06-22 11:48:02,link,191,13,24,228
52150999700,"Starring Rihanna, several pics show Rih posing in a sparkly dress and diamond necklaces. 🔥 🔥 🔥",2016-06-16 07:25:00,link,186,100,11,297
52150999700,Game of Thrones star Kit Harington is eyeing a new kind of battle in Call of Duty!,2016-06-23 22:23:01,link,187,82,50,319
5281959998,How much do you know about Brexit and the EU?,2016-06-23 03:33:00,link,1,96,33,130
95926963131,"In such tough times, PEOPLE wants to hear about something positive that's happened to you recently. 💛 Share your uplifting story in the comments! #sharesomethingpositive",2016-06-17 16:02:15,photo,52,67,39,158
7245371700,"Keep doing you, Ariel Winter.",2016-06-23 16:14:56,link,11,93,38,142
112638779551,"The entire MLB is divided on the Pete Rose vs. Ichiro Suzuki debate. 

But Wednesday, an unlikely person gave a surprising answer on how to fix it: former San Francisco Giants star Barry Bonds.",2016-06-15 11:07:53,link,46,96,48,190
112638779551,Bubba Watson is the early leader for making the putt of the tournament.,2016-06-16 12:06:16,link,52,59,29,140
112638779551,LA Kings fans: Good move or nah?,2016-06-16 18:28:21,link,3,10,26,39
52150999700,Chris Pratt's excitement over Guardians of the Galaxy is adorable. (via HelloGiggles),2016-06-18 00:17:00,link,12,51,27,90
75932763901,This former child star recently came out as bisexual! Click here to find out who —> http://bit.ly/28EBx6G,2016-06-15 10:30:01,photo,59,43,2,104
86680728811,"The car that killed Star Trek actor Anton Yelchin was a 2015 Jeep Grand Cherokee, a model recently included in a voluntary safety recall for its ""rollaway"" risk.",2016-06-20 17:14:03,link,192,7,19,218
25902406772,A baseball game can't end with a finish much more exciting than this one.,2016-06-21 21:08:32,link,178,52,8,238
52150999700,An alum from The Good Wife is joining Blindspot in a MAJOR role.,2016-06-22 11:44:29,link,152,56,38,246
75932763901,SHE POPPED! See which Hollywood star just showed off her huge baby bump! —> http://bit.ly/28TkFQ1,2016-06-24 18:00:00,photo,47,11,24,82
112638779551,"""You're basically throwing your body off a three-story building..."" U.S. Olympic diver David Boudia explained.",2016-06-16 06:51:08,link,97,98,16,211
52150999700,Imagine Maisie Williams and Norman Reedus battling it out on Survivor. 😂,2016-06-23 11:45:41,link,36,81,47,164
13652355666,"Brenda Lee Marquez-McCool stood in front of her son, shielding him from bullets.",2016-06-21 09:46:00,link,162,61,24,247
7245371700,It's her first GQ cover.,2016-06-15 10:58:27,link,177,13,19,209
25902406772,LeBron James is ALL IN on The Godfather this postseason.,2016-06-15 12:54:25,link,121,94,48,263
86680728811,"Chile's 7-0 win over Mexico in the Copa América Centenario 2016 may have inspired some soccer fans to celebrate with barbecues, a contributing factor in the increased air pollution recorded in some Chilean cities.",2016-06-22 02:34:03,link,44,38,40,122
52150999700,"Hey there, Krazee-Eyez! Get ready for a new season of Curb Your Enthusiasm with these essential throwbacks.",2016-06-18 17:52:00,link,113,60,17,190
52150999700,Blake Lively and Ryan Reynolds are the sweetest Hollywood couple. 💕,2016-06-23 15:27:00,link,116,22,41,179
95926963131,This cannot be unseen. 😳 (via Today Show),2016-06-15 02:00:34,link,40,62,17,119
112638779551,"Knockout artist Thiago ""Marreta"" Santos now faces Gegard Mousasi at UFC 200.",2016-06-20 12:21:36,link,84,40,39,163
52150999700,This takes friend-roomies to a whole new level. 🌟,2016-06-23 05:31:00,link,172,39,12,223
10513336322,"""I came away with a host of questions. Among them: why is it that the song Donald J. Trump's campaign uses to mark his arrival and departure is Elton John's ""Tiny Dancer?"" Is it more troubling, or less troubling, knowing that no one in the audience really cares what he says? And could it be that because his supporters are not all drawn from the lunatic fringe, but in fact represent a broad cross-section of regular people, and far more women than would seem possible or rational, that he could actually win?""",2016-06-17 08:00:00,link,141,74,35,250
25902406772,UEFA Euro 2016 is heating up.,2016-06-15 17:53:38,link,113,61,23,197
18807449704,This girl just skewered Donald J. Trump with one joke.,2016-06-15 10:45:00,link,186,77,40,303
112638779551,Never heard of the #USOpen leader? Don't worry; nobody else has either.,2016-06-17 09:34:47,link,194,65,9,268
18807449704,UPDATE: Body of toddler dragged into water by alligator has been recovered.,2016-06-15 18:30:00,video,99,66,29,194
112638779551,The Golden State Warriors decided to switch things up before Sunday's Game 7.,2016-06-19 19:11:23,link,38,50,34,122
112638779551,The Philadelphia Eagles rookie was sprung with the help of some garden shears and a well-placed leg kick.,2016-06-15 20:03:29,link,14,27,46,87
95926963131,Tom Hiddleston has an interesting connection to Prince William of Wales!,2016-06-15 20:27:01,link,144,72,26,242
25902406772,A scary moment for the Chicago Cubs and Pittsburgh Pirates.,2016-06-17 21:30:03,link,32,19,27,78
95926963131,Lane's parents say they are overwhelmed by the support they've received from around the country.,2016-06-20 16:56:07,link,39,16,18,73
86680728811,Russian police arrested five people in connection with the drowning of at least 15 children after a summer camp boating trip went disastrously wrong.,2016-06-20 22:31:55,link,160,76,8,244
95926963131,Greg Zanis is spreading love to those who need it most. ❤️,2016-06-18 16:20:07,link,104,77,47,228
10513336322,The skin comes out in goosebumps and tingles run up the spine. But how particular pieces of music can induce such rapturous effects in people has stumped researchers for centuries.,2016-06-17 10:40:00,link,192,11,42,245
7245371700,"""YG ain't the same YG no more.""",2016-06-15 22:17:47,link,181,9,4,194
7245371700,J.K. Rowling reps for the underdogs.,2016-06-23 12:44:29,link,25,40,6,71
25902406772,Here are how the teams rank after the quarterfinals.,2016-06-20 09:52:30,link,191,93,21,305
25902406772,Whoa.,2016-06-21 11:58:52,link,141,18,29,188
5281959998,"Breaking News: Donald J. Trump is replacing his campaign manager, Corey Lewandowski, as he prepares for a tough general election race.",2016-06-20 08:49:45,link,1,11,31,43
95926963131,Gwyneth Paltrow's apartment is as pristine as you'd imagine. (via People Great Ideas),2016-06-17 11:02:05,link,194,86,50,330
75932763901,She's following in Kim Kardashian West's footsteps — and some might even say she's better! Find out who —> http://bit.ly/1S4khvy,2016-06-20 00:00:00,photo,159,66,5,230
95926963131,"The woman, who served in the Navy for 8 years, took to Facebook to express her disappointment with stereotypes.",2016-06-15 15:24:06,link,162,53,20,235
18807449704,But haven't we all been there?,2016-06-17 13:09:32,link,165,1,10,176
18807449704,"""I was told that a male teacher had complained he was uncomfortable because I wasn't wearing a bra.""",2016-06-22 09:30:00,link,123,61,16,200
10606591490,It has to do with the way you pay.,2016-06-20 10:30:05,link,80,59,44,183
25902406772,Tim Tebow lent his support to a former teammate.,2016-06-21 16:59:34,link,5,28,30,63
18807449704,"If this leak is correct, big things could be coming up in the next episode of Game of Thrones.",2016-06-17 16:00:52,link,11,8,35,54
10513336322,"""He may surprise you, or he may not. If he doesn't then only you can decide what to do next, but remember that the pain of survival is greater than the pain of growth.""",2016-06-18 01:20:01,link,136,88,2,226
86680728811,"Donald J. Trump says he's open to the possibility of continuing to declare LGBT pride month and that ""it wouldn't bother"" him to celebrate Ramadan with an Iftar dinner at The White House.",2016-06-21 16:29:15,link,130,12,1,143
25902406772,The Cleveland Cavaliers fans should love Richard Jefferson.,2016-06-16 21:52:02,link,70,10,19,99
52150999700,Celebrate the first day of summer with DJ Earworm's latest AWESOME mash-up! ☀️ 🎶,2016-06-20 19:57:00,link,82,8,43,133
10513336322,"""It's hard to accept that your own offspring has covered up the murder of her own child.""

Neal Gray speaks to the Guardian about his six-year-old granddaughter Ellie Butler, whose father, Ben Butler, has been convicted of her murder.",2016-06-21 10:20:00,video,189,1,31,221
52150999700,"Alyssa Edwards and Adore Delano fans, RuPaul's Drag Race is back and it's better than EVER!",2016-06-19 18:01:00,link,194,77,34,305
86680728811,"An Australian rodent may have become the first victim of extinction as a result of human-caused climate change, researchers say.",2016-06-15 01:35:00,link,113,98,10,221
13652355666,Ruff morning?,2016-06-23 09:13:00,link,165,96,3,264
18807449704,Late-night hosts react to the Orlando shooting.,2016-06-15 08:30:00,video,33,4,16,53
86680728811,"U.S. Navy developing a diving helmet with a heads-up display embedded inside to display text messages, diagrams, photographs and even augmented reality videos.",2016-06-21 04:30:24,link,193,45,44,282
112638779551,#NASCAR #TBT: Dale Earnhardt Jr. said his late father helped him escape this flaming crash. Daryl Motte for @TheBuzzer.,2016-06-23 13:08:01,video,43,38,4,85
7245371700,This massacre has left us angry and afraid. Here's what you can do to help.,2016-06-19 13:20:27,link,21,83,27,131
13652355666,NASA Astronaut Scott Kelly is ready for his next adventure.,2016-06-15 09:29:00,link,142,54,20,216
5281959998,Daily Briefing: Here's what you need to know today.,2016-06-22 05:31:10,link,78,74,10,162
86680728811,A jury has convicted a former Vanderbilt football player of encouraging his teammates to rape an unconscious woman he had been dating. It took jurors just over four hours of deliberation Saturday before finding Brandon Vandenburg guilty on several counts. http://abcn.ws/1Y2W2H2,2016-06-19 17:19:36,link,65,83,44,192
5281959998,Your banking password may be about to expire — forever.,2016-06-21 13:25:00,link,183,32,46,261
5281959998,"Antonio Perkins, 28, accidentally caught his own fatal shooting on video. He is the latest example of the ""no gatekeeper"" world of live streaming.",2016-06-17 17:26:22,link,42,57,45,144
95926963131,"With Angelina Jolie and Brad Pitt's genes coursing through their veins, it isn't hard to believe that the Jolie-Pitt kids are destined for greatness. (via HelloGiggles)",2016-06-22 02:00:20,link,169,62,46,277
86680728811,"As investigators piece together potential motives for the deadliest mass shooting in U.S. history, the focus now turns toward the shooter's wife for possible answers. http://abcn.ws/1sGdyDo",2016-06-15 07:45:00,link,174,48,16,238
18807449704,"You okay there, Justin Bieber?",2016-06-17 17:39:46,link,36,61,37,134
5281959998,"Mark Zuckerberg covers his laptop camera with tape. Is it paranoia, or just good practice?",2016-06-22 16:25:00,link,67,100,15,182
95926963131,Wreckage of the EgyptAir flight that mysteriously vanished has been reportedly found.,2016-06-15 17:01:15,link,12,69,33,114
5281959998,"While you're watching Romania on the field during UEFA EURO, see in real time its chances of advancing to the next round.",2016-06-19 01:30:00,link,48,35,17,100
25902406772,"""What's a shirt?"" JR Smith is the best JR Smith there is.",2016-06-22 12:00:22,link,27,64,10,101
10513336322,What would their Britain look like?,2016-06-22 05:20:00,link,182,59,13,254
7245371700,"Pretty Little Liars showrunner I.Marlene King gives an exclusive scoop on the all the ""epic"" romance to come this season.",2016-06-21 09:57:05,link,60,65,17,142
112638779551,"He goes fast for a living, but NHRA's Antron Brown says he's not ready for the Top Thrill Dragster at Cedar Point. #NHRAonFOX PROcast",2016-06-23 11:32:10,video,43,5,49,97
13652355666,Apple to RNC: Nope.,2016-06-21 03:44:00,link,146,4,30,180
13652355666,C-SPAN itself is changing.,2016-06-24 01:30:00,link,103,69,6,178
52150999700,The Me Before You director is keeping busy with The Selection Series.,2016-06-17 21:16:00,link,177,24,25,226
75932763901,"NAMES REVEALED! After making her big baby announcement, Kylie Jenner revealed TWO names on Snapchat! —> http://bit.ly/28PRTju",2016-06-21 20:30:00,photo,176,23,30,229
75932763901,"While battling with lyme disease, Yolanda Foster makes an unexpected confession that's left fans speechless —> http://bit.ly/1VZCv8k",2016-06-15 15:30:00,photo,27,70,26,123
7245371700,"10 years since the release of her first country single, and Taylor Swift's anthems of confessional heartbreak have never been more timely.",2016-06-23 02:55:34,link,120,20,28,168
52150999700,Justice League star Ben Affleck is ready for Batman's next epic adventure. 👊🏼,2016-06-21 10:16:00,link,83,62,49,194
95926963131,Botched doctor Terry Dubrow isn't sold on the new trend.,2016-06-19 08:00:54,link,110,63,12,185
112638779551,Elias Theodorou - The Spartan says Sam Alvey won't be smiling anymore after he's finished with him at UFC Fight Night on Saturday.,2016-06-17 13:03:01,link,122,57,36,215
112638779551,"Wait, what just happened? This first pitch at a Daytona Tortugas game was flippin' awesome. 

Rachel Bonnetta for @TheBuzzer",2016-06-23 14:13:15,video,17,62,20,99
25902406772,"The Colorado Rockies now have 10 days to trade, release, or waive Reyes.",2016-06-15 12:33:21,link,158,13,3,174
75932763901,Giuliana and Bill Rancic's son isn't so little anymore! Wait until you see how big Duke has gotten in this new photo (via Closer Weekly) —> http://bit.ly/1TZO4Kk,2016-06-17 03:00:00,photo,94,60,32,186
75932763901,WEDDING BOMBSHELL! We definitely weren't expecting to hear this until after Blac Chyna and Rob Kardashian had their baby —> http://bit.ly/28R44yQ,2016-06-23 08:30:00,photo,92,19,43,154
86680728811,House Democrats are engaged in a sit-in on the House floor to protest GOP inaction on gun violence.,2016-06-22 12:39:05,link,49,73,47,169
75932763901,"Blake Lively started an uproar when she uploaded this picture. And when you see the caption, you'll understand the MAJOR controversy —> http://bit.ly/28NMjiE",2016-06-22 18:30:01,photo,91,63,22,176
86680728811,"The New York billionaire has slowly begun to add paid staff in a handful of swing states — Wisconsin and Iowa, among them — even as campaign officials concede the presumptive presidential nominee has little desire or capacity to construct the kind of massive national operation that has come to define modern-day White House campaigns: http://abcn.ws/1Up7Wqk",2016-06-18 14:48:26,link,137,31,27,195
10606591490,Witness an epic proposal one year in the making.,2016-06-18 03:30:11,link,110,61,41,212
13652355666,"""We're not going to let someone take this away from us.""",2016-06-15 11:42:00,link,46,63,32,141
10606591490,From bigger emojis to invisible ink.,2016-06-15 06:30:19,link,199,10,8,217
5281959998,"Many baby boomers are becoming de facto innkeepers through sites like Airbnb, HomeAway and VRBO - Vacation Rentals By Owner.",2016-06-18 03:55:00,link,123,20,18,161
75932763901,Chrissy Teigen and John Legend's daughter is following in her mommy's footsteps! Click here to see Luna's first modeling shot —> http://bit.ly/28MXRSF,2016-06-22 15:00:01,photo,166,39,27,232
86680728811,Man in custody in Belgium after claiming to have been kidnapped and strapped with a bomb belt - the bomb squad discovered the belt was a fake and contained only salt and cookies.,2016-06-21 07:44:41,link,17,81,20,118
7245371700,Travis Scott is playing with fire.,2016-06-15 10:07:06,link,45,20,15,80
95926963131,"Demi Lovato's social media feeds have gone ""Stone Cold.""",2016-06-21 12:59:14,link,189,35,29,253
25902406772,"There couldn't be a ""Great One"" without a great dad.",2016-06-19 12:12:37,link,77,76,48,201
75932763901,"NUDE! When you see the bottom half of Kylie Jenner's picture, you'll understand why fans are FREAKING out —> http://bit.ly/1rsJp9y",2016-06-16 19:30:00,photo,16,71,13,100
112638779551,Ken Griffey Jr. is helping to grow the game.,2016-06-16 21:03:51,link,35,93,43,171
5281959998,Bill Nye The Science Guy loves his morning coffee.,2016-06-19 08:25:00,link,37,46,21,104
10606591490,Good news for Adele fans.,2016-06-23 14:05:13,link,168,21,48,237
10513336322,"""TV had been afraid to show this side of women up till now. Hollywood and TV networks are a big misogynist machine and it wants you to aspire to the perfect female form, and the perfect man seducing her, with the men pulling the strings. But that's not true life. The men are not pulling the strings here and that is in great evidence. It is liberating and scary and invigorating to be a part of.""",2016-06-17 13:20:00,link,97,94,27,218
75932763901,GONE VIRAL: This young woman's Instagram profile has everyone talking – and it's because of her shocking resemblance to @Kylie Jenner! –> http://bit.ly/1VEGQyL,2016-06-19 00:00:00,photo,82,74,48,204
86680728811,"During her concert in Detroit on Tuesday night, Beyoncé began ""Halo"" by saying the song is about love and ""I would like to dedicate it to all of the family members who lost family members in Florida."" http://abcn.ws/23abPTt",2016-06-15 11:45:00,link,186,2,12,200
112638779551,"Good news, Washington Capitals fans",2016-06-22 20:47:57,link,91,29,41,161
52150999700,Selena Gomez knows how to shake it off—and we're lovin' it!,2016-06-21 06:37:05,link,95,49,29,173
5281959998,"A summertime recipe for one of ""the finest dishes of the Italian diaspora in America."" Thanks, Sam Sifton!",2016-06-23 19:25:00,link,165,16,45,226
52150999700,The young Star Trek actor's death has officially been ruled an accident.,2016-06-21 16:07:21,link,29,61,48,138
25902406772,An updated look at LeBron James's Finals track record compared to his contemporaries.,2016-06-20 13:41:17,photo,81,63,34,178
25902406772,The Pittsburgh Penguins have a choice to make between Matt Murray and Marc-Andre Fleury.,2016-06-16 14:09:46,link,63,1,24,88
7245371700,"Proof Kendall Jenner is only human, just like the rest of us.",2016-06-22 15:03:58,link,99,69,6,174
7245371700,Thoughts on the Pretty Little Liars premiere??,2016-06-22 08:11:10,link,126,79,48,253
7245371700,Basically sums up my love story in 4 minutes.,2016-06-23 18:40:11,link,99,51,11,161
52150999700,Xena: Warrior Princess marked a seriously legendary moment for women in film.,2016-06-17 16:02:00,link,30,75,10,115
25902406772,Robert Ayers keeps it real about the Tampa Bay Buccaneers improvement this off season.,2016-06-20 15:41:08,link,80,40,42,162
52150999700,Matt LeBlanc and James Corden faced off in the ultimate scooter race! 😂,2016-06-15 06:50:00,link,3,68,35,106
10513336322,"First, evangelical hedge fund manager Jonathan Ruffer bought Auckland Castle for £15m. Now he's putting on what's billed as the biggest live show in Britain since the 2012 Olympics featuring Romans, Vikings, flaming arrows, jousting knights and a 1,000-strong cast.",2016-06-21 07:20:00,link,104,35,31,170
112638779551,"""I grew up being a Kobe Bryant fan of course…before I was a Kevin Durant fan"" - LA Lakers' Brandon Ingram after being drafted No 2 overall in the #NBADraft.",2016-06-23 19:34:57,video,151,51,24,226
75932763901,SO ADORABLE! This green-eyed cutie looks just like her famous daddy! —> http://bit.ly/28OhBr9,2016-06-21 16:00:00,photo,45,34,36,115
25902406772,"Ahh, the life of a New York Jets fan.",2016-06-15 08:58:03,link,80,24,46,150
52150999700,"Soon after Michael Weatherly's exit, Wilmer Valderrama joins NCIS as series regular: http://share.ew.com/MQP8TkF",2016-06-17 15:41:50,video,64,22,10,96
10606591490,"""Now I understand why some people hate me!""",2016-06-16 16:30:18,link,138,76,12,226
95926963131,The 28-year-old and her 3 friends were getting ready to close out their tab when she first heard the gunshots.,2016-06-17 13:14:05,link,148,86,1,235
112638779551,"Did Cristiano Ronaldo snub his opponent?

Nicole Dabeau for @TheBuzzer.",2016-06-17 18:41:49,video,41,8,12,61
86680728811,"What we learned from the 2016 primary: Big money doesn't matter anymore, retail campaigning is dead, and Democrats still like to fall in love.",2016-06-15 19:04:04,link,50,39,37,126
25902406772,Welcome to the Eagle party.,2016-06-18 13:20:32,link,63,18,42,123
5281959998,Smart tart.,2016-06-18 05:55:00,link,99,15,10,124
86680728811,"Alabama teen wanted to scare her friends, but the prank turned into a joke on her when she couldn't get out of the purple dinosaur head.",2016-06-21 22:05:35,link,51,48,50,149
86680728811,"Mother's photo shows her son playing in lake near Disney resort on the same day a 2-year-old boy was attacked by a gator in nearly the same spot. ""I can assure you alligators were not on my mind at all when Channing was in the water.""",2016-06-17 04:30:11,link,72,37,15,124
7245371700,I can't believe this FRIENDS (TV Show) episode almost didn't exist. (via AOL),2016-06-22 16:10:12,link,1,75,12,88
95926963131,Money is no object for Republican National Committee nominee Donald J. Trump.,2016-06-23 21:14:04,link,144,60,50,254
25902406772,Nothing like hitting some dingers from an aircraft carrier.,2016-06-21 19:09:04,link,44,8,22,74
86680728811,"Roboticist and artist Alexander Reben tells ABC News he wanted to create a machine that would spur debate around sci-fi author Isaac Asimov's ""First Law"" of robotics, which says a robot may not harm a human being: http://abcn.ws/28EyH1v",2016-06-15 11:20:00,link,113,33,7,153
25902406772,Dance like there's no one watching!,2016-06-15 13:13:02,link,154,53,36,243
112638779551,Draymond Green's Game 6 outfit might earn him another flagrant.,2016-06-16 18:55:09,link,77,87,34,198
52150999700,"Clear eyes, full hearts, can't lose! Friday Night Lights stars reunite and reveal where their characters are now: http://share.ew.com/NdDrqO3 ❤️",2016-06-15 17:29:00,video,6,32,49,87
86680728811,NEW: IOC upholds Olympic ban on Russia's track and field athletes; every other Russian athlete to undergo independent doping evaluations.,2016-06-21 08:16:29,link,9,64,24,97
95926963131,The only martini recipes you need on National Martini Day! 🍸 (via People Great Ideas),2016-06-19 16:40:04,link,78,73,48,199
112638779551,"Stephen Curry says his father-in-law threatened with arrest in mistaken identity mishap before Game 6

http://www.foxsports.com/nba/story/steph-curry-says-father-in-law-menaced-in-mistaken-identity-incident-061716",2016-06-17 05:12:17,link,186,79,34,299
10606591490,"""This is what the audience has been waiting to see.""",2016-06-20 16:00:33,link,49,31,47,127
5281959998,"""Donald J. Trump is not just razing the standards of civil language, but of civility itself"" Robert Zaretsky writes in The New York Times Opinion Section.",2016-06-22 22:25:00,link,147,22,44,213
10606591490,"""You're in the great game now, and the great game is terrifying.""",2016-06-22 17:00:34,link,147,48,32,227
13652355666,The Golden State Warriors are one win away from notching their second consecutive NBA championship.,2016-06-16 20:30:00,link,53,49,21,123
18807449704,Hilarious.,2016-06-19 14:48:29,link,43,11,30,84
13652355666,"It's not the end of the world. It's monsoon season. Arizona residents and visitors beware, now through Sept. 30. http://usat.ly/1Q9jG1C",2016-06-16 19:50:00,video,81,92,49,222
7245371700,"Whoa, that's a lot of dough.",2016-06-19 10:49:01,link,13,25,27,65
52150999700,"When it comes to Harry Potter, Blake Lively is definitely a Ravenclaw.",2016-06-21 06:55:00,link,82,54,31,167
13652355666,"The gunman wrote on Facebook, ""now taste the Islamic state vengeance,"" according to Johnson's letter.",2016-06-15 22:40:00,link,3,77,38,118
25902406772,The two teams battle on Wednesday with everything on the line.,2016-06-22 10:51:59,link,162,81,15,258
52150999700,The Nicki Minaj and Jeremih Official verses are 🔥,2016-06-15 20:39:00,link,58,97,20,175
112638779551,Check out Ken Rosenthal's Bow Tie Cause during tonight's Pirates-Cubs game!,2016-06-18 18:35:13,link,41,64,49,154
7245371700,Logic is ~ killin' this ~.,2016-06-21 21:25:44,link,76,97,28,201
86680728811,"""We are increasingly seeing situations where people are getting infected with bacteria that are resistant to many if not all of the antibiotics [we currently use].""",2016-06-20 12:35:56,link,17,59,12,88
25902406772,Sam Vecenie will be grading each pick in this NBA Draft.,2016-06-23 18:54:45,link,31,80,20,131
112638779551,"It's a picture perfect day for the U.S. Open Championship at Oakmont Country Club. NFL on FOX's John Lynch welcomes you to our Saturday coverage.

Get comfortable, we're here all day!",2016-06-18 10:26:11,video,110,75,28,213
112638779551,"On Wednesday, Kevin Love wore his WWE championship belt to the Cleveland Cavaliers victory parade.

He also gave the crazy details on how he got the belt in the first place...",2016-06-22 14:49:33,link,65,22,47,134
25902406772,"The U.S. Open Championship Trophy is what everyone wants, but the money isn't too bad either.",2016-06-18 20:00:01,link,185,28,45,258
86680728811,Lightning has killed dozens of people in India over the past 24 hours - mostly farm laborers working in fields.,2016-06-22 10:45:47,link,72,43,2,117
18807449704,#Neverforget Meat Loaf's star role in Fight Club,2016-06-22 06:37:52,link,167,14,42,223
112638779551,How did the Golden State Warriors blow a 3-1 lead in the NBA Finals? LeBron James is one explanation. This might be another.,2016-06-20 16:46:34,link,96,21,38,155
75932763901,Fans are FREAKING OUT over this throwback snap of Kourtney Kardashian — and you have to read the caption to understand why:  http://bit.ly/28Jjvvf,2016-06-20 13:00:00,photo,185,63,23,271
10606591490,It's not what you think.,2016-06-15 15:00:33,link,194,79,24,297
86680728811,"We're talking with Senator Chris Murphy (D-CT) who staged a 15-hour ""filibuster"" over gun control on the Senate floor in the wake of the Orlando shooting.",2016-06-17 10:38:01,video,110,9,46,165
10606591490,"""I didn't think my vote was going to matter too much.""",2016-06-24 10:30:19,link,170,12,45,227
10513336322,"""Women. Can't they just button it? Women, eh? Women! Whaddya gonna do? is the general message of these adverts.""",2016-06-23 11:00:00,link,18,60,28,106
52150999700,"Suicide Squad fans, this soundtrack with twenty one pilots and Eminem is going to be RAD.",2016-06-17 11:40:00,link,24,65,45,134
52150999700,Tom Hiddleston has something very important to tell the world. 😍,2016-06-20 11:53:00,link,22,6,40,68
25902406772,Kevin Love enjoyed some beverages in a way that would make Stone Cold Steve Austin proud.,2016-06-20 00:08:48,link,57,48,37,142
52150999700,The Good Wife star is joining Richard Gere for a new project! 👌🏼,2016-06-23 21:59:00,link,36,83,18,137
86680728811,"The cases are tragically similar: Student-athletes at two elite universities accused of sex crimes against unconscious women. Yet one is given six months in a county jail, while the other is facing at least 15 years in prison. 

But the comparison is not so simple. http://abcn.ws/21sCaea",2016-06-18 15:14:36,link,131,29,26,186
86680728811,Rep. Bob Dold joined Democrats on the House floor Tuesday by calling for the chamber to take up gun control measures after the Orlando nightclub shooting.,2016-06-15 17:34:45,link,102,90,19,211
25902406772,What brilliant goal by U.S. Soccer star Clint Dempsey.,2016-06-16 21:19:31,link,176,33,23,232
7245371700,"Beyoncé has fooled us all, again.",2016-06-20 04:36:13,link,86,89,36,211
75932763901,SERIOUSLY?! Find out who is leaving NOTHING to the imagination on the beach (via Life & Style Weekly) —> http://bit.ly/28KyUK0,2016-06-21 02:15:00,photo,68,39,45,152
112638779551,"From one legend to another.

Jim Brown hands the championship trophy to LeBron James & the Cleveland Cavaliers.",2016-06-22 17:40:11,video,57,25,22,104
10606591490,"Serena Williams: ""For most of my career, I've been real quiet, and secretive about what I do.""",2016-06-21 22:00:16,link,186,1,34,221
52150999700,"""It hurts me as a man, as a human being, and as a gay person."" —Ricky Martin",2016-06-15 13:18:01,link,85,84,2,171
52150999700,Chris Hemsworth shocked the cast with his improv skills in Ghostbusters!,2016-06-17 10:56:00,link,42,26,8,76
7245371700,Cheers to more Taylor Swift + Tom Hiddleston Beyoncé dance-offs like this.,2016-06-19 08:01:56,link,20,93,36,149
86680728811,"The efforts to stop Donald Trump from securing the nomination at the Republican National Convention are heating up, with nearly three dozen delegates dialing into a conference call to discuss coordinating methods to block his coronation in Cleveland: http://abcn.ws/1Y08MOJ",2016-06-17 20:38:26,link,27,99,48,174
112638779551,"LeBron James is on the verge of doing the impossible. In the meantime, he's reminded us all of his boundless greatness:",2016-06-17 09:30:00,link,175,81,40,296
86680728811,"DEVELOPING: British politician reportedly shot after town hall meeting; 52-year-old man arrested, police say. http://abcn.ws/1Q80kd7",2016-06-16 08:51:39,photo,85,42,9,136
75932763901,PREGNANT! Kourtney Kardashian's latest Instagram post has fans completely shocked –> http://bit.ly/28HWGNc,2016-06-16 13:01:06,photo,74,91,43,208
25902406772,"For the first time ever, two teams will meet in Game 7 of the NBA Finals with the exact same aggregate score.",2016-06-17 11:14:39,photo,46,28,24,98
25902406772,Kevin Durant has a massive decision to make.,2016-06-20 21:37:33,link,111,45,18,174
112638779551,"Chicago Bulls GM Gar Forman on the Derrick Rose trade: ""The sense I got is that Derrick will be excited about New York.""",2016-06-22 20:25:01,video,166,18,28,212
10513336322,"""The problem here, for the most part, isn't faulty guns or insufficient training. It's dangerous people using guns effectively.""",2016-06-23 10:20:00,link,44,52,30,126
7245371700,"Congrats, Mila Kunis and Ashton Kutcher!",2016-06-15 20:31:27,link,54,99,37,190
13652355666,Mid-July is going to be the busiest time to fly this summer.,2016-06-22 19:36:00,link,72,96,46,214
112638779551,Chad Clay was dismissed following his second arrest in four months.,2016-06-23 13:57:47,link,146,33,39,218
52150999700,Zoe Saldana has addressed the controversy in-depth.,2016-06-18 15:13:01,link,171,71,49,291
112638779551,Wanna watch Game 7 in person? You might have to take out a loan.,2016-06-18 00:52:17,link,132,11,36,179
75932763901,"If you think Kim Kardashian West's cleavage is out of control here, just wait until you see her latest snapshot! —> http://bit.ly/28NfEIb",2016-06-22 10:30:00,photo,136,65,33,234
95926963131,Lane Graves' family is admitting that they are unable to speak publicly after suffering the horrific accident.,2016-06-18 15:20:09,link,12,75,29,116
5281959998,"An enormous model of Noah's ark is rising in Kentucky. Ken Ham, the man behind it, wants to use the boat to promote a version of history at odds with science.",2016-06-22 21:55:00,video,134,16,15,165
5281959998,Senate Republicans have agreed to allow a series of votes on restricting gun sales. Do any of the measures stand much chance of passage? Probably not.,2016-06-19 11:25:00,link,23,82,14,119
18807449704,Big news for YouTube.,2016-06-23 21:33:01,link,115,52,24,191
5281959998,Is the massacre in Orlando really the worst mass shooting in U.S. history?,2016-06-18 14:55:00,link,145,96,39,280
112638779551,Denver Broncos players already know replacing Peyton Manning will be an impossible task.,2016-06-22 13:54:59,link,69,63,6,138
52150999700,"The season 10 Doctor Who set looks PERFECT, Whovians. 😍😱",2016-06-23 12:56:00,link,83,5,11,99
52150999700,"This Disney Channel mash-up is AWESOME, Adventures in Babysitting fans! 👏🏼",2016-06-23 22:45:00,link,15,66,34,115
52150999700,Wands were raised to remember a fallen wizard. ✨ ❤️,2016-06-15 18:36:00,link,147,57,28,232
25902406772,Peanut Tillman is all about the Carolina Panthers.,2016-06-19 15:16:02,link,4,22,27,53
13652355666,"Paul Martin was nervous about dancing in a wheelchair at his daughter's wedding, so he took dance lessons.",2016-06-17 16:11:00,video,92,34,36,162
75932763901,CONGRATS! The gender of  Megan Fox's third baby has been revealed! Click here to find out what she's having —> http://bit.ly/28W5lVo,2016-06-24 19:30:00,photo,78,66,25,169
52150999700,This sci-fi packed trailer for HBO's Westworld is finally here! 🙀,2016-06-19 20:26:17,link,60,17,37,114
52150999700,Rachel Platten reacted to Calysta Bevier's STUNNING performance on America's Got Talent. 🎤  💯,2016-06-22 23:04:00,link,75,60,28,163
112638779551,"Hey Internet, Sacramento Kings guard Ben McLemore has a new challenge for you!

Kristen Balboni for @TheBuzzer",2016-06-16 14:37:49,video,160,31,14,205
10513336322,"""Lady Warsi's defection handed remain a powerful argument against those of us voting to leave the EU. I know about this because it's often been used against me: how can a black lefty be on the same side of the argument as Nigel Farage? And my response has always been the same? I'm not leave with Farage – I'm leave with Dennis Skinner and a handful of other brave Labour MPs.""",2016-06-22 04:40:00,link,141,53,30,224
18807449704,These critics are NOT pleased.,2016-06-21 20:30:00,link,48,81,44,173
10606591490,She was trapped inside for 45 minutes.,2016-06-22 02:00:25,link,148,23,16,187
10606591490,"""We need to change the law to protect the next Emily Doe from the next Brock Turner.""",2016-06-22 21:00:19,link,111,55,26,192
25902406772,You KNOW Denzel will be ready for his Training Day with the Chicago Bulls.,2016-06-23 20:14:58,photo,78,24,16,118
52150999700,"Don't worry, Finding Nemo fans! The original voice of Nemo is still in Finding Dory: http://share.ew.com/ilg3aqY 👌🏼",2016-06-21 09:36:00,video,18,66,7,91
5281959998,Daily Briefing: Here's what you need to know today.,2016-06-16 05:30:01,link,106,15,18,139
10513336322,"Donald J. Trump's campaign war chest is dwarfed by that of rival Hillary Clinton, representing one of the biggest financial mismatches in presidential election history, figures show.",2016-06-21 04:00:01,link,27,29,45,101
18807449704,The GOP said the revision was made to make the statement more inclusive but many felt it did the opposite.,2016-06-15 14:58:34,link,196,19,27,242
95926963131,Peek inside Jessie James Decker's Florida home—the lavish 4 bedroom will give you house goals. (via People Great Ideas),2016-06-19 00:00:00,video,147,90,11,248
25902406772,"What does your favorite NBA team need going into the draft? 

We broke 'em all down right here.",2016-06-21 18:05:38,link,92,71,20,183
10606591490,Trump has come under fire from many in his own party,2016-06-19 09:30:29,link,148,29,21,198
13652355666,Talk about a wild run-in!,2016-06-20 22:51:00,link,141,58,15,214
25902406772,Showtime Boxing has ALL the goods.,2016-06-17 12:21:06,video,79,52,15,146
52150999700,Viola Davis got a seriously terrifying gift from her Suicide Squad co-star Jared Leto. 😳,2016-06-23 13:11:00,link,62,14,21,97
75932763901,"Jessica Simpson's daughter, Maxwell, is typically the star of her famous mother's Instagram — but when was the last time you saw her son, Ace?! JUST WAIT until you see how grown up he looks: http://bit.ly/28JIqw6",2016-06-20 14:00:00,photo,91,51,1,143
5281959998,"With little money and big dreams, unaccompanied minors from Africa travel to the Spanish enclave of Melilla. There, they wait in limbo. http://nyti.ms/28LG7dI

Photo: Guillem Valle/MeMo",2016-06-21 12:55:00,photo,116,92,42,250
10513336322,"Behind the scenes, in the largely invisible world of digital organising on which modern presidential campaigns increasingly depend, Trump is not merely lagging behind – he's not on the map.",2016-06-22 17:00:00,link,12,11,28,51
112638779551,Some more heady praise for LeBron James from another Cleveland Cavaliers legend.,2016-06-21 14:29:08,link,35,69,49,153
10606591490,An ex emails you to ask if you want to get dinner on Tuesday. Is it a date?,2016-06-18 18:00:32,link,135,16,3,154
112638779551,"Did you know Bubba Watson went to the movies while everyone else was golfing today? And when a U.S. Open Championship golfer asks for BBQ advice, Shane Bacon and Holly Sonders are here to help. #USOpen",2016-06-17 18:26:08,video,140,32,25,197
7245371700,He was reportedly assaulted  by someone on Drake's team.,2016-06-23 10:57:07,link,145,39,29,213
112638779551,Paige VanZant turns down WWE offer to focus on her upcoming fight with Rowdy Bec Rawlings,2016-06-23 19:07:12,link,146,83,19,248
10513336322,"Hannah Fry: ""The Gottman Institute's study about arguments in long-term relationships concludes that couples with the best chance at long-term success are the ones with a low negativity threshold: if something's wrong, they speak up about it immediately.""",2016-06-19 04:00:00,link,71,55,14,140
13652355666,"BREAKING:  Omar Mateen told negotiators during the bloody rampage: ""I'm in Orlando and I did the shootings.""",2016-06-20 10:05:35,link,6,59,38,103
7245371700,"Thanks for this, Meghan Trainor.",2016-06-19 11:13:52,link,27,93,16,136
112638779551,How does Conor McGregor spend his down time? Just hanging out with Rihanna backstage in Dublin.,2016-06-22 14:16:17,link,93,37,12,142
86680728811,"FBI chief James Comey says sometimes Americans look for someone to blame, citing ""a certain national naïveté about whether bad things can really be avoided in all situations.""",2016-06-20 22:09:24,link,121,38,47,206
112638779551,"How many bros does it take to pull off this workout?

Rachel Bonnetta for @TheBuzzer",2016-06-23 13:59:49,video,61,49,33,143
95926963131,"During more than two decades in the spotlight, Selma Blair has seen her share of ups and downs.",2016-06-22 15:05:05,link,125,20,43,188
10513336322,How the hell did it happen?,2016-06-24 00:40:00,link,198,21,20,239
7245371700,"Aww, it's hard to spread your wings in this big, big world.",2016-06-17 23:03:48,link,134,18,25,177
18807449704,SAME,2016-06-21 04:30:01,link,33,77,28,138
95926963131,Exclusive: Alligator captured on video in the same location where 2-year-old Lane Graves was snatched (via People Video),2016-06-17 08:28:00,video,13,35,5,53
25902406772,LeBron James is getting pretty good at this whole blocking the MVP thing.,2016-06-19 20:23:51,link,41,24,4,69
112638779551,"On Monday, Michigan Football coach Jim Harbaugh announced he and his wife are having another baby...

But it isn't just that Harbaugh is having a baby... but HOW he announced it...",2016-06-20 14:42:14,link,179,28,26,233
112638779551,"Lil B agrees to lift ""Based God"" curse on Kevin Durant if he signs with the New York Knicks

http://www.foxsports.com/nba/story/lil-b-agrees-to-lift-curse-on-kevin-durant-if-he-signs-with-knicks-062316",2016-06-24 00:13:50,link,153,90,36,279
25902406772,Shooters are a hot commodity for NBA teams.,2016-06-22 12:46:23,link,30,81,47,158
25902406772,Aida Mendes became the oldest person to ever carry an Olympic torch.,2016-06-17 13:32:37,link,35,81,8,124
10606591490,"The textbooks describe homosexuality as a ""psychological disorder.""",2016-06-16 05:30:03,link,23,7,27,57
112638779551,Referencing a pretty popular former wrestling champion.,2016-06-20 12:23:24,link,184,80,8,272
10606591490,See where people get the most and least sleep.,2016-06-24 06:00:21,link,184,94,47,325
52150999700,The original voice of our favorite football head is returning to Hey Arnold in a new role!,2016-06-18 12:36:00,link,61,85,9,155
52150999700,It will always be Texas forever for the Friday Night Lights cast! ❤️🏈,2016-06-19 19:07:00,link,119,44,45,208
10513336322,"""'Take control' makes a visceral appeal to older people's psyches; to retrieve control of our personal lives is high on our wish list, our failure to do so a daily experience. The prospect of independence takes us back to the good old days when we did things 'our way', unaided by Johnny Foreigner.

This menu of nostalgia and xenophobia is a toxic dish with a peculiar appeal to the elderly palate.""",2016-06-22 03:20:00,link,65,18,34,117
86680728811,"Rep. Seth Moulton, a former U.S. Marine Corps officer who served four tours in Iraq, says his military experience gives him a unique vantage point on issues of national security and the nation's veterans.",2016-06-15 18:43:04,link,178,15,4,197
7245371700,Women are teaming up to fight sexual harassment in public. (via ATTN:),2016-06-23 15:35:27,video,158,7,22,187
5281959998,Donald J. Trump regularly boasts that he is self-funding his presidential bid. He's also shifting plenty of money back to himself in the process.,2016-06-21 14:55:00,link,149,57,46,252
75932763901,"New mom Chrissy Teigen is normally loved by fans, but this pic shows her true personality — and when you see the full photo you'll understand why! –> http://bit.ly/1UEtfS7",2016-06-17 16:30:00,photo,158,81,13,252
10606591490,"A conflict that began in 1964 and killed 220,000 may finally be over",2016-06-23 18:30:35,link,17,86,2,105
95926963131,Gwen Stefani celebrated Blake Shelton's birthday in most epic way possible!,2016-06-19 12:40:09,link,160,33,18,211
95926963131,America's Got Talent's 13-year-old opera singer reveals how she was feeling leading up to auditioning in front of the infamous Simon Cowell. (via People Video),2016-06-18 04:00:00,video,156,75,33,264
18807449704,This footage is pretty unreal!,2016-06-21 21:24:47,link,64,36,17,117
18807449704,What do you think of the new Ghostbusters theme song?,2016-06-23 13:30:00,link,179,21,30,230
7245371700,Ricky Martin's words are powerful.,2016-06-15 18:08:12,link,145,31,42,218
112638779551,"Thirty years ago on June 19, Maryland Basketball star and Boston Celtics No. 1 pick Len Bias died. He was 22 and it was two days after he was selected in the NBA Draft.",2016-06-19 03:53:58,link,105,89,38,232
95926963131,Prince William has pretty much always been crush-worthy.,2016-06-21 22:00:11,link,189,92,9,290
10513336322,Whichever way it's gone – at least it's over!,2016-06-23 17:40:00,link,120,83,35,238
86680728811,Polls are open across Britain for the Brexit referendum on whether the country should remain in the European Union.,2016-06-23 01:12:06,link,61,66,48,175
10606591490,"""Love is always in fashion.""",2016-06-18 22:00:44,link,199,77,8,284
5281959998,"When Paul Ryan left the speaker's chair, Democrats shouted: ""Shame! Shame! Shame!""",2016-06-23 10:55:00,link,20,21,35,76
112638779551,Driveable Par 4. You know Bubba Watson is going for it. #LexusRCF,2016-06-16 14:39:50,video,10,58,37,105
25902406772,Leo Messi made history in dramatic fashion.,2016-06-21 20:48:34,link,10,1,5,16
13652355666,The hottest ticket in town might need a little more scrutinizing.,2016-06-18 12:32:00,link,93,18,6,117
18807449704,Woman runs her boyfriend over with a car after discovering his HIV diagnosis.,2016-06-16 17:39:19,video,109,53,20,182
5281959998,"While you're watching Poland on the field during UEFA EURO 2016, see in real time its chances of advancing to the next round.",2016-06-21 10:10:00,link,59,23,9,91
10606591490,6. Label your emotions.,2016-06-16 07:00:25,link,55,79,49,183
7245371700,What The Wonder Years' pop-punk album meant to a young black man growing up in the suburbs and grappling with grief.,2016-06-21 18:55:17,link,50,95,3,148
75932763901,This star is down almost 200 pounds! Click here to find out who —>http://bit.ly/1OGcfZt,2016-06-20 00:45:00,photo,83,87,49,219
52150999700,YESSS! Channing Tatum and Jenna Dewan Tatum are behind the new Step Up Movie series! 🙌🏻,2016-06-23 20:44:00,link,131,63,27,221
18807449704,This LED cube is basically the lava lamp of the future.,2016-06-18 04:00:00,video,76,89,29,194
13652355666,Comforter-in-Chief.,2016-06-16 15:48:00,link,87,11,5,103
86680728811,"""As far as I'm concerned I'd be very happy to continue to self-fund,"" Donald J. Trump said in an interview at Trump Tower with ABC News' ABC World News Tonight with David Muir.",2016-06-21 17:45:59,link,97,70,47,214
75932763901,OMG! 'Teen Mom' star Farrah Abraham shocks fans with another risqué video — and we certainly did not expect this: http://bit.ly/1QRwAuD,2016-06-18 15:30:00,photo,117,70,4,191
13652355666,"From dad jokes to dad bods, there's a lot to celebrate this Father's Day! Tag the rad dads in your life to wish them a #HappyFathersDay and read about how these social media dads take on fatherhood: http://usat.ly/1tulYxO",2016-06-19 10:05:00,photo,35,82,41,158
5281959998,"Cecil Pierce landed his airboat on Causey's Island in the Florida Everglades. Airboating is on the decline in the Everglades.

More from the week in pictures: http://nyti.ms/1UnV0RL

Photo: Scott McIntyre for The New York Times",2016-06-17 23:25:00,photo,56,74,44,174
52150999700,"On Wednesdays, we wear pink—and soon, you'll be able to watch Mean Girls EVERY day on Netflix! 👌🏼",2016-06-21 17:46:00,link,190,37,16,243
112638779551,Jason Day struggled through his opening nine holes at Oakmont.,2016-06-17 11:44:30,link,169,89,41,299
75932763901,"CONGRATS, Ben Affleck! Get the exciting details (via Closer Weekly) —> http://bit.ly/1VpbVpX",2016-06-17 06:00:00,photo,73,57,20,150
95926963131,One of Kylie Jenner's biggest objectives in life is the pursuit of the perfect selfie. (via PeopleStyle),2016-06-16 08:50:03,link,134,21,11,166
86680728811,Ticketmaster is offering millions of customers free tickets to certain events or discounts as part of a class-action settlement.,2016-06-20 11:00:00,link,101,20,9,130
10513336322,Can Bose's first Bluetooth noise-cancelling headphones live up to expectations?,2016-06-21 09:30:00,link,126,53,27,206
95926963131,A Florida mom's Facebook post in defense of 2-year-old Lane Graves' parents has gone viral.,2016-06-16 19:54:03,link,113,34,9,156
25902406772,"Peyton Manning has been enjoying his retirement, including the Super Bowl celebrations with the Denver Broncos.",2016-06-20 18:26:58,video,61,12,44,117
52150999700,South Park creators on why video games might be the future of the series: http://share.ew.com/RwQSRxS,2016-06-16 05:25:00,video,77,57,29,163
10606591490,"Models at Milan Men's Fashion Week had ""spotty, blemished and inflamed skin.""",2016-06-22 03:30:22,link,143,92,39,274
52150999700,Finding Dory is swimming past Independence Day: Resurgence by a LOT. 🐠💸,2016-06-23 18:39:00,link,81,86,12,179
13652355666,Dangerously hot.,2016-06-21 13:57:00,link,181,71,28,280
7245371700,Some were better than others. (via Refinery29),2016-06-23 09:06:06,link,151,70,42,263
10513336322,"A Vote Leave board member has resigned after it emerged that she promoted anti-Muslim material on social media, including an image of a white girl in the middle of a group of people wearing burqas saying: ""Britain 2050: why didn't you stop them Grandad?""",2016-06-21 02:20:01,link,171,19,29,219
18807449704,Give us the sarcastic emoji immediately!,2016-06-15 04:55:52,link,36,80,19,135
25902406772,Some stunning results in the WWE.,2016-06-19 22:31:41,link,177,1,42,220
25902406772,"LeBron James, MY GOODNESS.",2016-06-16 22:51:29,link,11,66,14,91
95926963131,"If you're on Team Dean, Gilmore Girls fans, hope you're sitting down for this. (via HelloGiggles)",2016-06-17 02:00:31,link,134,90,41,265
18807449704,"Tom DeLonge: ""It's all around us. I know of stuff I can't talk about right now.""",2016-06-20 17:32:45,link,61,13,6,80
10513336322,"""You name it and I am it. One of the dreaded 10%, the undecided who will decide this thing. How galling that something monumental should be left in the hands of people who did not make up their minds months ago, who are confused by this utterly false binary we are being asked to vote on: between two different, but actually very similar elites.""",2016-06-23 07:20:00,link,85,97,27,209
52150999700,"We fully support this The X-Files idea, Gillian Anderson! 😱",2016-06-17 18:59:00,link,84,79,6,169
7245371700,"Oh, so that's how Demi Lovato gets flawless skin.",2016-06-19 18:14:14,link,164,64,40,268
10513336322,"""If I try to stand up to my first ex she becomes abusive and brings up our break-up, which was more than seven years ago. I don't know what to do. If I put my new partner first I get accused of neglect; if I play nice with my first ex she takes advantage.""",2016-06-19 03:20:00,link,5,24,43,72
10606591490,"""The Republican rules aren't a suicide pact""",2016-06-18 09:15:06,link,33,52,25,110
10606591490,"Selena Gomez: ""It will be fine…it will be fast.""",2016-06-21 09:30:23,link,155,46,5,206
10513336322,"""What I don't understand is: why are you Brits feeling so bold? Why are people who are so scared of losing their status at the same time so willing to take such a huge risk? It seems you only have things to lose from this referendum.""",2016-06-21 04:20:00,link,91,12,40,143
10513336322,The UK's historic decision to end its 43-year love-hate relationship with the European Union represents a bloodless turning point in British history to rank alongside the two world wars of the 20th century. So what now?,2016-06-23 23:20:00,link,149,74,23,246
18807449704,"""Beware ladies, beware!""",2016-06-17 18:23:14,link,84,84,4,172
7245371700,Almost all of my favorite Disney + Nickelodeon stars have been on Broadway.,2016-06-18 05:08:48,link,165,27,44,236
10513336322,'There's no such thing as a Brusselo!',2016-06-23 21:14:01,link,127,92,31,250
75932763901,SHE'S GETTING SO BIG — and looking more and more like her famous parents every day! Find out who they are here:  http://bit.ly/28OhBr9,2016-06-22 07:30:00,photo,116,74,50,240
5281959998,Many Donald J. Trump supporters don't take his promises literally.,2016-06-22 09:25:01,link,79,51,42,172
5281959998,"Until now, infectious cancer was seen as something of a fluke in the natural world. Now scientists wonder if it could be more widespread.",2016-06-22 13:55:00,link,156,93,42,291
18807449704,Hideous,2016-06-20 06:55:44,link,143,41,3,187
5281959998,An artist who's been called a da Vinci of the lawn mower created this colossal portrait of Beethoven in a field in upstate New York.,2016-06-19 12:25:00,link,68,32,13,113
7245371700,A team of writers unanimously decide to nominate a swarm of bees to prevent a possible Donald J. Trump presidency.,2016-06-20 22:39:29,link,69,97,15,181
95926963131,Lane's parents created the foundation and released an emotional statement on its site.,2016-06-21 11:09:02,link,14,86,36,136
112638779551,"Dustin Johnson didn't let a possible penalty stop him from winning the U.S. Open Championship

Kristen Balboni for @TheBuzzer",2016-06-19 20:35:54,video,168,75,35,278
7245371700,Can you believe that was almost 13 years ago?,2016-06-19 04:20:07,link,87,76,7,170
18807449704,"If you loved last night's Game of Thrones, wait until you see the extended version of the episode's final faceoff.",2016-06-20 12:57:52,link,144,39,48,231
75932763901,"This video of Reese Witherspoon dancing is getting A LOT of attention — and when you hear what song she's rocking out to, you'll understand why! (via Closer Weekly) —> http://bit.ly/28JfLsk",2016-06-20 22:00:00,photo,70,4,34,108
112638779551,"The good, the bad, and the WTF? Here is the 2016 NBA Finals Fashion Roundup:

http://www.foxsports.com/nba/story/nba-finals-fashion-roundup-062016",2016-06-20 15:57:10,link,158,88,23,269
52150999700,Matt Bomer looks ravishing even back in the golden age. 😍🔥✨,2016-06-16 20:30:00,link,142,98,50,290
10606591490,Hillary Clinton has raised much more money than Donald J. Trump.  http://ti.me/28L8eF0,2016-06-21 20:15:42,video,73,67,31,171
112638779551,"Hello Kevin Love, goodbye Kevin Love.",2016-06-16 20:30:33,link,145,29,36,210
10513336322,"With the over-64s already comprising just over a quarter of its 128 million population, Japan is at the forefront of devising ways to tackle the challenges posed by a super-ageing society, including the stigma attached to people with Alzheimer's disease and other forms of dementia.",2016-06-16 04:40:00,link,86,93,2,181
10606591490,It increases the likelihood of receiving a response by 30%.,2016-06-18 19:30:06,link,30,77,26,133
10513336322,"""This country is in a pretty messed up state. We have a media that haven't done this question any justice. We have politicians no one trusts and we've got all sorts of divisions. It's clearly not the time to throw at the country this very simple binary question. Not only do I have no sense of what's going to happen, but I have no sense of what the hell is coming next.""",2016-06-22 08:00:00,video,3,80,48,131
95926963131,Andrea Yates suffered from postpartum psychosis when she drowned her five children.,2016-06-20 11:02:03,link,70,21,5,96
75932763901,Unexpected news for Orange Is the New Black! — We're so excited! --> http://bit.ly/1W3PS7F,2016-06-17 14:30:00,photo,80,45,42,167
25902406772,Looks like Dwight Howard will be back on the market.,2016-06-21 19:30:04,link,181,12,30,223
10606591490,Great news.,2016-06-17 07:00:18,link,158,14,9,181
13652355666,Brenda Tracy was gang-raped nearly 18 years ago by four men — two of whom played for Mike Riley.,2016-06-23 07:51:00,link,23,46,46,115
52150999700,John Oliver went OFF on the National Rifle Association on Last Week Tonight with John Oliver.,2016-06-20 10:10:01,link,184,28,32,244
112638779551,Mike Riley finally gave a platform to a woman who long criticized him for not seriously addressing her sex assault allegations,2016-06-22 21:12:38,link,149,84,39,272
75932763901,IT'S A GIRL! See which TV star just welcomed Baby No. 2 (via Closer Weekly) —> http://bit.ly/1U9wOWf,2016-06-16 05:30:00,photo,115,12,43,170
25902406772,Malachi Richardson never lost his hunger to #DreamFearlessly. His hard work will pay off at the Draft with American Family Insurance.,2016-06-20 21:31:09,video,15,72,16,103
13652355666,"The missiles are believed to have a range of 2,180 miles, which would put key U.S. military bases in Japan and Guam at risk.",2016-06-21 22:35:00,link,97,78,40,215
95926963131,"Jamie Lynn Spears shares how she coped with her teen pregnancy while her hit Nickelodeon show ""Zoey 101"" was still on the air.",2016-06-22 23:00:00,video,32,45,38,115
13652355666,The former NFL star was scheduled to begin trial on murder charges when he was found dead.,2016-06-15 13:40:00,link,134,90,17,241
95926963131,"As the nation mourns after the mass shooting in Orlando, touching stories of humanity poke through the sadness.",2016-06-17 09:56:07,link,53,93,28,174
75932763901,BABY ON BOARD! See who's expecting baby No. 1 with a MUCH older man —> http://bit.ly/28Jlkpb,2016-06-20 10:30:00,photo,20,4,28,52
52150999700,6 seasons of Stark suffering have all been leading to THIS Game of Thrones battle.,2016-06-16 12:45:41,link,135,68,46,249
10513336322,"Will Self: ""I have a cigarette ready-rolled and a coffee percolator loaded the night before; then I simply roll out of bed, fuel up and set to it.""",2016-06-19 02:40:00,link,144,39,40,223
5281959998,Our top 10 comments of the week.,2016-06-18 11:25:00,link,46,21,12,79
18807449704,Leonardo DiCaprio is being forced to testify in 'Wolf Of Wall Street' libel lawsuit.,2016-06-20 18:59:24,video,76,50,6,132
75932763901,YIKES! See which famous lady let it ALL hang out on the red carpet!! –> http://bit.ly/1ZWjKC1,2016-06-17 12:30:01,photo,110,25,24,159
86680728811,"NEW THIS MORNING: Second flight data recorder from the crashed EGYPTAIR plane that killed 66 people on board has been recovered from the Mediterranean Sea, officials say. http://abcn.ws/1UA5BKC",2016-06-17 07:40:56,link,122,76,26,224
75932763901,This is so much more disturbing than anyone could've anticipated. 💔,2016-06-16 11:00:00,link,193,52,47,292
25902406772,JR Smith might go shirtless for the rest of the summer.,2016-06-21 09:21:42,photo,179,86,4,269
75932763901,"After being dumped by ex Taylor Swift over the phone, there's more sad news for Calvin Harris — and this time it hits even closer to home —> http://bit.ly/28O9Geb",2016-06-22 18:00:00,photo,148,79,4,231
75932763901,"Scott Disick posted and then immediately deleted this Instagram post, but not before fans could take a screenshot! When you read the caption, you'll understand why fans are MAD! –> http://bit.ly/1YwCEAM",2016-06-17 18:30:00,photo,10,78,6,94
25902406772,hmm,2016-06-15 20:16:09,link,82,1,50,133
25902406772,Leo Messi is making history in the Copa América Centenario 2016.,2016-06-18 19:57:10,link,51,83,9,143
7245371700,Chad has somehow managed to get back at one of his former competitors AFTER leaving The Bachelorette.,2016-06-23 07:04:36,link,169,97,13,279
18807449704,Stop downloading all your WhatsApp photos!,2016-06-15 08:09:26,link,192,79,36,307
10513336322,"""His message barely changed, it was just presented in a far more conventional way.""",2016-06-22 15:30:01,link,143,75,42,260
52150999700,"'80s fans, you're going to have this Everybody Wants Some Movie playlist on repeat all day. 😍🎶",2016-06-23 14:11:00,link,146,71,26,243
